1111100110,ארנונה כללית שוטפת ,1000,1000,1442,-442,44,44000
1111200110,ארנונה כללית פגורים ,1800,1800,1960,-160,8,8000
1413100210,אגרות מים שוטף ,2690,2690,2099,591,21,21000
1413101210,אגרת מים פיגורים ,3300,3300,3078,222,6,6000
1312200420,"השתת' הורים הזנה יוח""א ",12,12,40,-28,233,233000
1312200740,השתת' ממפעל הפיס ,0,0,0,0,0,0
1312300410,השתתפות הורים ,0,0,15,-15,0,0
1312800420,הכנסות מקייטנה ,0,0,0,0,0,0
1312800790,"השתת' בקייטנה-מש""מ ",0,0,0,0,0,0
1313200420,"השתת' הורים הזנה יוח""א ",30,30,178,-148,493,493000
1313201420,השתת' הורים הזנת יוחא-אלע ,80,80,37,43,53,53000
1313202420,"השתת' הורים הזנה יוח""א ",65,65,75,-10,15,15000
1313203420,"השתת' הורים-הזנת יוח""א ",90,90,26,64,71,71000
1313203740,השתת' מ.פיס ציוד ורהוט ,0,0,0,0,0,0
1313204420,"השתת' הורים הזנת יוח""א-אנ ",50,50,0,50,100,100000
1313204740,השתת' מפעל הפיס ,0,0,0,0,0,0
1313205420,השתת' הורים הזנה ,20,20,13,7,35,35000
1313205740,השתת' מ.פיס ציוד ורהוט ,0,0,35,-35,0,0
1313300730,השתת' מוסד לביטוח לאומי ,0,0,0,0,0,0
1313800420,הכנסות מקייטנות ,0,0,0,0,0,0
1315209740,השתת' מפעל הפיס ,0,0,0,0,0,0
1315210740,השתת' מ.הפיס ציוד ורהוט ,0,0,0,0,0,0
1317600420,השת' הורים רווחה חינוכית ,0,0,0,0,0,0
1317901740,השתת' מפעל הפיס ,0,0,0,0,0,0
1342201420,השתת' הורים בקייטנת אמהות ,0,0,0,0,0,0
1121000290,תעודות ואישורים ,10,10,118,-108,80,80000
1212300220,אגרת אשפה ,0,0,0,0,0,0
1213300290,אגרת רישוי עסקים ,0,0,0,0,0,0
1214300220,מלחמה בכלבת-אגרת חיסון ,0,0,0,0,0,0
1233100220,"אגרות,רשיונות בניה ",0,0,0,0,0,0
1233400790,אגרות בנייה-שימעונים ,586,586,506,80,13,13000
1240000000,נכסים צבוריים ,0,0,0,0,0,0
1269000290,הכנסות-מכירת מכרזים ,2,2,0,2,100,100000
1269000660,הכנסות מימון ,3,3,16,-13,433,433000
1269000661,ריבית הלואות עובדים ,0,0,0,0,0,0
1269000690,הכנסות שונות ,70,70,94,-24,34,34000
1269000691,שונות קרן מקפת ,20,20,27,-7,35,35000
1269001290,אגרות בית המשפט)גביה( ,4,4,1,3,75,75000
1312000000,חינוך קדם יסודי ,0,0,0,0,0,0
1312200000,גני ילדים גיל חובה ,0,0,0,0,0,0
1312300000,גני ילדים טרום חובה ,0,0,0,0,0,0
1313000000,חינוך יסודי ,0,0,0,0,0,0
1313200000,"בי""ס יסודי חורה א' ",0,0,0,0,0,0
1313201000,"בי""ס יסודי אלעטאונה ",0,0,0,0,0,0
1313202000,"בי""ס יסודי חורה ב' ",0,0,0,0,0,0
1313203000,"בי""ס יסודי אלביאדר ",0,0,0,0,0,0
1313204000,"בי""ס אלאנדלס ",0,0,0,0,0,0
1313302000,"ביה""ס אלופאא לאוטסטים ",0,0,0,0,0,0
1314000000,חטיבת ביניים מקיף רבין ,0,0,0,0,0,0
1315000000,חינוך על יסודי ,0,0,0,0,0,0
1315200000,"בי""ס תיכון - עמל ",0,0,0,0,0,0
1315201000,"בי""ס תיכון - עתיד אלנור ",0,0,0,0,0,0
1315202000,"ביס"" תיכון סכנין ",0,0,0,0,0,0
1315203000,"בי""ס תיכון חדש ",0,0,0,0,0,0
1315204000,"בי""ס תיכון אלסלאם ",0,0,0,0,0,0
1316000000,מינוך גבוה ,0,0,0,0,0,0
1317000000,שרותים נוספים לחינוך ,0,0,0,0,0,0
1317300000,שירות פסיכולוגי חינוכי ,0,0,0,0,0,0
1317600000,רווחה חינוכית ,0,0,0,0,0,0
1322000000,פעולות תרבות ,0,0,0,0,0,0
1323000420,השתת' הורים/תושבים ,0,0,0,0,0,0
1323000740,השתת' מ.פיס ספרייה ,0,0,0,0,0,0
1328000000,נוער ,0,0,0,0,0,0
1328300420,השתתפות תושבים ,0,0,0,0,0,0
1328400420,השתת' תושבים בש.משלימים ,0,0,0,0,0,0
1328400790,השת' בקיטנה-מ.השלטון מקומ ,0,0,0,0,0,0
1329300790,השתת' מועצה להסדר ההימורי ,0,0,0,0,0,0
1329900490,הכנסות ספורט ,0,0,0,0,0,0
1341000000,מינהל הרווחה ,0,0,0,0,0,0
1342000000,רווחת הפרט והמשפחה ,0,0,0,0,0,0
1343000000,שרותים לילד ולנוער ,0,0,0,0,0,0
1344000000,שרותים לזקן ,0,0,0,0,0,0
1345000000,שרותים למפגר ,0,0,0,0,0,0
1346000000,שרותי שיקום ,0,0,0,0,0,0
1347000000,שירותי תיקון ,0,0,0,0,0,0
1348000000,עבודות קהילתיות ,0,0,0,0,0,0
1413000000,משק המים ,0,0,0,0,0,0
1413100310,היטל צריכה ,0,0,0,0,0,0
1413300220,אגרת מוני מים ,110,110,78,32,29,29000
1312200920,עוזרות לגננות ,1500,1500,1771,-271,18,18000
1312200923,"תשלומי הורים חומרים-ג""י ",12,12,12,0,0,0
1312200924,"ה.נלוות ח.מיוחד-גנ""י ",15,15,19,-4,26,26000
1312200925,העשרה ח.מיוחד-גני ,0,0,0,0,0,0
1312200926,"שכ""ד גני חובה ",105,105,118,-13,12,12000
1312200927,"אגרת תלמידי חוץ-גנ""י ",70,70,0,70,100,100000
1312200928,"גנ""י יוח""א ",270,270,272,-2,0,0
1312200929,השתת' מ.חינוך שונות ,0,0,85,-85,0,0
1312300920,"שכ""ל גני ילדים קדם חובה ",5000,5000,5242,-242,4,4000
1312300923,"תשלומי הורים חומרים-ט""ח ",25,25,24,1,4,4000
1312300924,מ.חינוך-השתת' בשכירות ,0,0,0,0,0,0
1312300926,"שכ""ד גנ""י ט.חובה ",60,60,155,-95,158,158000
1312300927,אגרת תלמידי חוץ-יסודי א' ,0,0,0,0,0,0
1312301927,אגרת תלמידי חוץ-אלעטאונה ,0,0,0,0,0,0
1312302920,השתת' מ.חינוך - מעגן ,0,0,0,0,0,0
1312800920,השתת' מ.חינןך-חוויה קיצית ,0,0,0,0,0,0
1313200920,שרתים-יסודי חורה א' ,235,235,224,11,4,4000
1313200921,מזכירים-יסודי חורה א' ,75,75,78,-3,4,4000
1313200922,אגרת שיכפול יסודי חורה א' ,10,10,12,-2,20,20000
1313200923,תשלום הורים חומרים חורה א ,18,18,17,1,5,5000
1313200924,סייעות כיתתיות חורה א ,0,0,0,0,0,0
1313200925,"מנב""ס מזכירים חורה א ",0,0,0,0,0,0
1313200926,פדיון חופשה ש+מ-יסודי א' ,0,0,0,0,0,0
1313200927,אגרת תלמידי חוץ-יסודי א' ,75,75,0,75,100,100000
1313200928,"יוח""א ביה""ס א' ",0,0,0,0,0,0
1313200929,השתת' מ.חינוך - שונות ,34,34,0,34,100,100000
1313201920,שרתים- יסודי אלעטאונה ,370,370,363,7,1,1000
1313201921,מזכירים-יסודי אלעטאונה ,115,115,120,-5,4,4000
1313201922,אגרת שיכפול יסודי אלעטאונ ,68,68,14,54,79,79000
1313201923,תשלום הורים חומרים-אלעטונ ,32,32,29,3,9,9000
1313201924,חוק שילוב סייעות-בודדות ,410,410,545,-135,32,32000
1313201925,"מנב""ס ביה""ס אלעטאונה ",0,0,0,0,0,0
1313201927,אגרת תלמידי חוץ עטאונה ,33,33,0,33,100,100000
1313201928,"יוח""א ביה""ס אלעטאונה ",0,0,0,0,0,0
1313201929,"שח""פ ביה""ס אלעטאונה ",0,0,0,0,0,0
1313202920,שרתים-יסודי חורה ב' ,320,320,341,-21,6,6000
1313202921,מזכירים-יסודי חורה ב' ,100,100,104,-4,4,4000
1313202922,אגרת שיכפול-יסודי חורה ב' ,12,12,17,-5,41,41000
1313202923,תשלום הורים חומרים-חורה ב ,25,25,24,1,4,4000
1313202924,סייעות כיתתיות אלמגד ,85,85,89,-4,4,4000
1313202925,"מנב""ס מזכירים אלמג'ד ",0,0,0,0,0,0
1313202927,אגרת תלמידי חוץ-אלמג'ד ,50,50,0,50,100,100000
1313202928,"יוח""א ביה""ס אלמג'ד ",0,0,0,0,0,0
1313202929,"השתת' מ.חינוך תל""ן ",0,0,0,0,0,0
1313203920,"שרתים בי""ס ביאדור ",427,427,468,-41,9,9000
1313203921,מזכירים יסודי ,136,136,151,-15,11,11000
1313203922,אגרת שכפול ,17,17,23,-6,35,35000
1313203923,תשלום הורים -חומרים ,40,40,38,2,5,5000
1313203924,סייעות כיתתיות אלביאדר ,42,42,45,-3,7,7000
1313203925,"מנב""ס מזכירים אלביאדר ",0,0,-7,7,0,0
1313203927,אגרת תלמידי חוץ -אלביאדר ,153,153,0,153,100,100000
1313203928,"יוח""א ביה""ס אלביאדר ",0,0,0,0,0,0
1313203929,"שח""פ ביה""ס אלביאדר ",0,0,15,-15,0,0
1313204920,שרתים ,260,260,289,-29,11,11000
1313204921,מזכירים ,80,80,92,-12,15,15000
1313204922,אגרת שכפול ,10,10,15,-5,50,50000
1313204923,תשלומי הורים חומרים ,20,20,23,-3,15,15000
1313204925,פדיון חופשה+ש.מ. ,0,0,0,0,0,0
1313204926,פידיון חופשה- ש+מ ,0,0,0,0,0,0
1313204927,אגרת תלמידי חוץ-אלאנדלוס ,50,50,0,50,100,100000
1313204928,"השתת' מ.חינוך-יוח""א אנדלו ",0,0,0,0,0,0
1313204929,השתת' מ.חינוך שונות ,0,0,33,-33,0,0
1313205920,שרתים - אלזהרא ,195,195,248,-53,27,27000
1313205921,מזכירים - אלזהרא ,60,60,84,-24,40,40000
1313205922,אגרת שכפול יסודי - אלזהרא ,0,0,13,-13,0,0
1313205923,תשלומי הורים חומרים - אלזהרא,15,15,17,-2,13,13000
1313205924,סייעות כיתתיות - אלזהרא ,0,0,11,-11,0,0
1313205925,פדיון חופשה+ש.מ ,0,0,0,0,0,0
1313205927,אגרת תלמידי חוץ-אלזהרא ,30,30,0,30,100,100000
1313205929,השתת' מ.חינוך שונות ,0,0,56,-56,0,0
1313300920,"שרתים בי""ס חינוך מיוחד ",191,191,239,-48,25,25000
1313300921,"מזכירים בי""ס חינוך מיוחד ",65,65,87,-22,33,33000
1313300922,אגרת שכפול-חינןך מיוחד ,9,9,11,-2,22,22000
1313300923,תש' הורים חומרים-ח.מיוחד ,6,6,6,0,0,0
1313300924,"סייעות כיתתיות ח""מ ",1127,1127,1390,-263,23,23000
1313300925,פידיון חופשה ש+מ ,1,1,0,1,100,100000
1313300926,"הזנת יוח""א ח""מ ",220,220,267,-47,21,21000
1313300927,אגרת תלמידי חוץ ,636,636,1247,-611,96,96000
1313300928,השתת' מ.חינוך שונות ,0,0,21,-21,0,0
1313300929,"שירותי היקף- ח""מ ",18,18,24,-6,33,33000
1313301920,ה.נלוות ח.מיוחד ערבי ,80,80,93,-13,16,16000
1313301922,"השתת' מ.חינוך הצטיידות ח""מ ",0,0,162,-162,0,0
1313301926,"השתת' מ.חינוך שכ""ד ח""מ ",75,75,0,75,100,100000
1313302920,השתת' מ.חינוך ,0,0,17,-17,0,0
1313302921,"מזכירים -בי""ס אלופפא ",0,0,11,-11,0,0
1313302922,"אגרת שכפול - בי""ס אלופפא ",0,0,3,-3,0,0
1313302924,סייעות כיתתיות אלופאא ,0,0,228,-228,0,0
1313302929,השתת' משרד חינוך שונות ,0,0,16,-16,0,0
1313400920,השתת' מ.חינוך מרכז מחוננים ,140,140,24,116,82,82000
1313400921,מזכירים - מחוננים ,0,0,7,-7,0,0
1313600920,"שרתים-מתי""א ",43,43,66,-23,53,53000
1313600921,"מזכירים-מתי""א ",86,86,132,-46,53,53000
1313600922,"אגרת שיכפול-מתי""א ",0,0,65,-65,0,0
1313600929,השתת' מ.חינוך שונות ,0,0,69,-69,0,0
1313700929,השתת' משרד חינוך שונות ,0,0,0,0,0,0
1314000920,"סל תלמיד חט""ב )ש+מ( ",615,615,1294,-679,110,110000
1314000922,"אגרת שיכפול פר תלמיד חט""ב ",0,0,0,0,0,0
1314000923,"חט""ב-הורים חומרים רבין ",0,0,0,0,0,0
1314000924,"חט""ב-ציוד למעבדות מחשבים ",0,0,0,0,0,0
1314001920,"סל חט""ב קהילתיים ",0,0,0,0,0,0
1315200920,"שכ""ל על יסודי - עמל ",2075,2075,2075,0,0,0
1315200923,"תשלום הורים חומרים-חט""ב ",0,0,0,0,0,0
1315201920,"שכ""ל על יסודי - עתיד אלנור ",3925,3925,3925,0,0,0
1315201929,השתת' מ. חינוך כתות חכמות ,0,0,0,0,0,0
1315202920,"שכ""ל על יסודי - סכנין ",1800,1800,1800,0,0,0
1315202929,השתת' מ. חינוך כתות חינוך ,0,0,0,0,0,0
1315203920,"רכב מנהלים בי""ס על יסודי ",0,0,0,0,0,0
1315203929,השתת' מ. חינוך כתות חכמות ,0,0,0,0,0,0
1315204920,"שכ""ל על יסודי - אלסלאם ",2000,2000,1387,613,30,30000
1315204921,"קרן השתלמות לשכ""ל ",0,0,62,-62,0,0
1315204922,אגרת שיכפול פר תלמיד ,0,0,16,-16,0,0
1315204923,"תשלום הורים חומרים-חט""ב ",0,0,36,-36,0,0
1315204924,"החזרה שכ""ל למורים ",0,0,26,-26,0,0
1315204925,"רכב מנהלים בי""ס ע""י ",0,0,9,-9,0,0
1315204926,גמול טיול-חוץ בית ,0,0,25,-25,0,0
1315204927,אגרת תלמידי חוץ ,75,75,0,75,100,100000
1315204928,דמי שתיה ,0,0,1,-1,0,0
1315204929,"שונות - גמיול הל""ל ",0,0,80,-80,0,0
1315205920,גמול טיול-חוץ בית ,0,0,0,0,0,0
1315206920,דמי בחינות בגרות ,0,0,0,0,0,0
1315207920,"דמי שתיה בי""ס על יסודי ",0,0,0,0,0,0
1315208920,"בראה וביגוד בי""ס על יסודי ",0,0,0,0,0,0
1315209920,מענק יובל על יסודי ,0,0,0,0,0,0
1315209921,"תוכנית מנ""ע קב.טיפול ",0,0,0,0,0,0
1315209922,הצטיידות תוכנית החומש ,0,0,0,0,0,0
1315209923,"השתת' בשכ""ד רבין ",0,0,0,0,0,0
1315209924,פ.בטיחותי+חינוך תעבורתי ,0,0,0,0,0,0
1315209927,מוחזקות פירפיאליות ,0,0,0,0,0,0
1315209928,תוכנית לימודים בלשון ,0,0,0,0,0,0
1315210927,השתת' מ.חינוך הכנסות שונו ,0,0,0,0,0,0
1315211920,"השתת' מ.החינוך ש""ש חט""ע ",0,0,0,0,0,0
1315211921,"השתת' מ.חינוך פרויקט טו""ב ",0,0,0,0,0,0
1315211922,פ.בטיחותיות+חינוך תעבורתי ,0,0,0,0,0,0
1316000920,השתת' מ.חינוך שרתים ,0,0,0,0,0,0
1316000921,השתת' מ.חינוך מזכירים ,0,0,0,0,0,0
1316000922,השתת' מ.חינוך א.שכפול ,0,0,0,0,0,0
1317100920,"קב""ט מוסדות חינוך ",35,35,38,-3,8,8000
1317300920,"שפ""י)פסיכולוגים חינוכיים( ",820,820,825,-5,0,0
1317300921,"שפ""י)הדרכה( ",0,0,18,-18,0,0
1317300922,"השתת' מ.חינוך-שפ""י מיוחד ",0,0,0,0,0,0
1317600920,רווחה חינוכית-מ.חינוך ,120,120,25,95,79,79000
1317601920,"השתת' מ חינוך שח""ר תוכנית או",140,140,0,140,100,100000
1317700920,"קב""ס ",150,150,96,54,36,36000
1317700921,"קב""ס - פרויקטים ",0,0,0,0,0,0
1317700922,"קב""ס חונכות נוער מנותק ",0,0,0,0,0,0
1317700923,"קב""ס מניעת נשירה ",0,0,0,0,0,0
1317801920,הסעות דרום ,2100,2100,3117,-1017,48,48000
1317802920,הסעות חינוך מיוחד דרום ,600,600,669,-69,11,11000
1317803920,"לווי הסעות ח""מ-מוסד ",350,350,409,-59,16,16000
1317900920,מדריכים לקידום נוער ,0,0,0,0,0,0
1317901920,שיפוצים בתי ספר ,170,170,183,-13,7,7000
1317901921,השתת' מ.חינוך ציוד ורהוט ,0,0,0,0,0,0
1317902920,פ.בטיחותיות+חינוך תעבורתי ,0,0,0,0,0,0
1317903920,שחיקת חינוך מבוגרים ,0,0,0,0,0,0
1317904920,השתת' מ.חינוך-מידע סטטסטי ,0,0,0,0,0,0
1317905920,הכנסות שונות ,60,60,34,26,43,43000
1317905921,הכנסות מיוחדות מ.חינוך ,0,0,0,0,0,0
1317906920,אגרת תלמידי חוץ ,0,0,0,0,0,0
1317907920,"מוביל לבי""ס-מניעת סמים ",0,0,9,-9,0,0
1317907921,חותם-הסכם מיקרוסופט ,0,0,-16,16,0,0
1317907922,"ציוד ראשוני לגנ""י-יוח""א ",0,0,58,-58,0,0
1317907923,"גנים יוח""א ",0,0,0,0,0,0
1317907924,מ.חינוך כיתות חכמות בנגב ,0,0,0,0,0,0
1317909920,"השתת' מ.חינוך אס""א ",0,0,0,0,0,0
1317930920,"אס""א-אלימות.סמים ואלכהול ",0,0,0,0,0,0
1317940920,נוער במרכז העניינים ,0,0,0,0,0,0
1317950920,פרוייקטים שונים ,0,0,0,0,0,0
1318000920,חינוך למבוגרים ,0,0,0,0,0,0
1319000920,חינוך מיוחד-שרותי היקף ,0,0,0,0,0,0
1341000930,שכר עובדי המחלקה ,593,593,473,120,20,20000
1341001930,הוצאות מינהליות ,0,0,0,0,0,0
1341002930,"כ""א לחינוך מיוחד ",60,60,36,24,40,40000
1341003930,פעולות אירגוניות ,0,0,17,-17,0,0
1341004930,רכישת ציוד יסודי ,0,0,0,0,0,0
1342200930,משפחות במצוקה בקהילה ,36,36,31,5,13,13000
1342201930,קייטנה לאמהות ,0,0,0,0,0,0
1342202930,טיפול בפרט ובמשפחה ,0,0,0,0,0,0
1342203930,טיפול באלכהולסטים ,7,7,7,0,0,0
1342204930,סיוע למשפחות עם ילדי א ,39,39,65,-26,66,66000
1342205930,טיפול בהורים ובילדיהם ,0,0,0,0,0,0
1342206930,צרכים ברשויות קולטות ,0,0,0,0,0,0
1342500930,סדנאות למשפחה ,0,0,0,0,0,0
1342600930,מרכז טיפול באלימות ,0,0,19,-19,0,0
1343501930,טיפול בילד בקהילה ,0,0,166,-166,0,0
1343502930,טיפול בילד בקהילה-פר ,0,0,0,0,0,0
1343503930,ת.לאומית ילד ונוער ,0,0,91,-91,0,0
1343504930,יצירת קשר הורים - ילדי ב ,0,0,2,-2,0,0
1343505930,טיפול במשפחות אומנה יומית ,37,37,0,37,100,100000
1343506930,מועדניות ביתיות ,210,210,0,210,100,100000
1343800930,אחזקת ילדים בפנימיות ,371,371,340,31,8,8000
1343801930,טיפול במשפחות אומנה ,0,0,133,-133,0,0
1343900930,ילדים מעון יום ,387,387,782,-395,102,102000
1343901930,מ.יום רשויות ,0,0,0,0,0,0
1344400930,טיפול בזקן בקהילה ,9,9,8,1,11,11000
1344401930,חימום לקשישים ,0,0,0,0,0,0
1344402930,מועונים לזקנים ,0,0,2,-2,0,0
1344403930,נופשונים להבראה )לקשיש( ,0,0,21,-21,0,0
1344404930,מועדון חברתי לבוגרים א ,0,0,19,-19,0,0
1345100930,סידור מפגרים במוסדות ,805,805,962,-157,19,19000
1345101930,סידור מפגרים במוסד ממש ,0,0,0,0,0,0
1345200930,מפגרים במעון טיפולי ,40,40,50,-10,25,25000
1345300930,שרותים תומכים למפגר ,8,8,3,5,62,62000
1345301930,נופשונים למפגר ,2,2,0,2,100,100000
1345302930,הסעות למ.יום למפגר ,14,14,14,0,0,0
1345305930,הסעות לאוטיסטים ,1,1,0,1,100,100000
1345400930,"מעשי""ם-מפעלי תעסוקה למ ",33,33,51,-18,54,54000
1346300930,דמי ליווי לעוור ,0,0,0,0,0,0
1346301930,הדרכת העוור ובני ביתו ,5,5,2,3,60,60000
1346302930,מכונים לראייה ירודה ,0,0,0,0,0,0
1346303930,מועדונים לעוור ,0,0,2,-2,0,0
1346304930,אחזקת נכים במשפחות אומנה ,0,0,0,0,0,0
1346305930,משפחות אומנה לשיקום ,0,0,0,0,0,0
1346400930,מפעלי שיקום ,0,0,0,0,0,0
1346500930,אחזקת נכים בפנימיות ,115,115,119,-4,3,3000
1346600930,נכים-מס.יום לילד המוגב ,46,46,25,21,45,45000
1346601930,מרכזי איבחון ושיקום ,0,0,0,0,0,0
1346700930,תכנית לילד החריג ,0,0,0,0,0,0
1346701930,שיקום נכים בקהילה-תעסוקה ,0,0,0,0,0,0
1346702930,מ.יום שיקומי לנכים ,173,173,181,-8,4,4000
1346703930,הסעות למ.יום שיקומי לנכים ,0,0,77,-77,0,0
1346704930,ליווי למ.יום שיקומי לנכים ,0,0,18,-18,0,0
1346800930,מפעלי שיקום-שיקום נכים ,0,0,0,0,0,0
1346801930,דמי תקשורת לחרשים ,0,0,0,0,0,0
1347100930,טיפול בנוער ובצעירים ,12,12,11,1,8,8000
1347102930,מקלט לנשים מוכות ,30,30,83,-53,176,176000
1347103930,טיפול בנערות במצוקה ,0,0,0,0,0,0
1347110930,טיפול בחבורות רחוב ,0,0,0,0,0,0
1347400930,שהות במקלט לנערות ,0,0,1,-1,0,0
1348200930,מרכזים קהילתיים ,0,0,0,0,0,0
1348201930,תוכנית עם הפנים לקהילה ,0,0,142,-142,0,0
1348202930,פיתוח ק.במגזר הכפרי ,0,0,13,-13,0,0
1348500930,עובדי שיקום שכונות ,0,0,12,-12,0,0
1213300940,השתתפות משרד הבריאות ,20,20,0,20,100,100000
1225000990,משרד התחבורה-בטיחות ,0,0,0,0,0,0
1225100990,"משרד התחבורה-זה""ב ",62,62,52,10,16,16000
1244400990,השתתפות מ.התחבורה ,0,0,0,0,0,0
1313202940,השתת' מ.הבריאות-רפואת שינ ,0,0,0,0,0,0
1317400990,משרד הבריאות ,130,130,142,-12,9,9000
1322000940,השתת' משרד המדע תרבות וספורט,0,0,0,0,0,0
1322001940,"השתת' משרד המדע,תרבות וספורט",0,0,100,-100,0,0
1328100940,השתת' מ.חינוך רכז השכלה ק.נ,45,45,83,-38,84,84000
1328200940,השתת' מ.חינוך - נוער ,50,50,48,2,4,4000
1328300940,השתת' משרד חינוך שונות ,0,0,0,0,0,0
1329300940,השתת' מ.חינוך פ.ספורט ,120,120,126,-6,5,5000
1343901990,"מ.יום רשויות-תמ""ת)משפחתון ",120,120,167,-47,39,39000
1379000990,איכות הסביבה ,0,0,0,0,0,0
1470000990,השתת' אגרת ביוב מ.מ.י ,1370,1370,0,1370,100,100000
1513000980,הוצאות אחרות ,0,0,0,0,0,0
1594000990,נזקי סופה ,0,0,0,0,0,0
1191000910,מענק כללי לאיזון ,9638,9638,9638,0,0,0
1196001910,מענק-משמר אזרחי ,0,0,0,0,0,0
1226100910,"משרד הפנים-מל""ח ",0,0,0,0,0,0
1244400910,השתת' משרד הפנים אחזקת כבישי,0,0,0,0,0,0
1268000910,"השתת' מ.הפנים - מפע""מ ",0,0,0,0,0,0
1353000910,השתתפות משרד הפנים ,0,0,0,0,0,0
1192001910,מענק רזרבת שר ,0,0,0,0,0,0
1192002910,מענק שיפוי פנסיה ,20,20,19,1,5,5000
1192003910,מענק-שיפוי קיצוץ ,0,0,0,0,0,0
1192004910,מענק-הגדלת שיעור המימוש ,0,0,0,0,0,0
1192005910,מענק מותנה בגביה ,1175,1175,1700,-525,44,44000
1192006910,משר הפנים מענק בחירות ,0,0,0,0,0,0
1192007910,מענק חד פעמי ,0,0,554,-554,0,0
1192008910,"מענק שיפוי קופ""ג ",17,17,8,9,52,52000
1192009910,משרד הפנים תקבולים שונים ,10,10,0,10,100,100000
1513000510,החזר הוצאות ש.ק. ,30,30,236,-206,686,686000
1513000590,"החזר ב""ל-דמי פגיעה ",5,5,1,4,80,80000
1591900690,החזר מקרן הלואות ,0,0,0,0,0,0
1594000540,החזר נזקי שריפה ,0,0,0,0,0,0
1594100540,תביעות מחברת ביטוח ,0,0,0,0,0,0
1594200910,השת' מ.פניים בבחירות רשות ,0,0,0,0,0,0
1599100910,מענק לכסוי גרעון ,0,0,320,-320,0,0
1599200910,מלווה למענק איזון ענק ,0,0,0,0,0,0
1116000110,ועדת הנחות חומריות ,4500,4500,6749,-2249,49,49000
1611100110,השכר הקובע ,722,722,720,2,0,0
1611100120,תוספות שאינן נכללות בש ,23,23,37,-14,60,60000
1611100140,החזר הוצאות ,200,200,221,-21,10,10000
1611100181,הפרשות סוציאליות ,216,216,223,-7,3,3000
1611100182,מיסים ועלויות ,73,73,75,-2,2,2000
1612000110,השכר הקובע ,110,110,125,-15,13,13000
1612000120,תוספות שאינן נכללות בש ,2,2,2,0,0,0
1612000130,שעות נוספות ,0,0,0,0,0,0
1612000140,החזר הוצאות ,22,22,21,1,4,4000
1612000181,הפרשות סוציאליות ,32,32,36,-4,12,12000
1612000182,מיסים ועלויות ,10,10,11,-1,10,10000
1613000110,השכר הקובע ,896,896,1050,-154,17,17000
1613000120,תוספות שאינן נכללות בשכר ,31,31,47,-16,51,51000
1613000130,שעות נוספות ,14,14,41,-27,192,192000
1613000140,החזר הוצאות ,303,303,337,-34,11,11000
1613000181,הפרשות סוציאליות ,239,239,287,-48,20,20000
1613000182,מיסים ועלויות ,95,95,112,-17,17,17000
1613000320,פיצויים ,0,0,0,0,0,0
1619000110,השכר הקבוע-בחירות ,0,0,0,0,0,0
1619000120,תוספות שאינן נכללות-בחירו ,0,0,0,0,0,0
1619000140,החזר הוצאות-בחירות ,0,0,0,0,0,0
1619000181,הפרשות סוציאליות-בחירות ,0,0,0,0,0,0
1619000182,מיסים ועלויות-בחירות ,0,0,0,0,0,0
1621000110,השכר הקובע ,407,407,423,-16,3,3000
1621000120,תוספות שאינן נכללות בשכר ,4,4,8,-4,100,100000
1621000130,שעות נוספות ,0,0,0,0,0,0
1621000140,החזר הוצאות ,41,41,43,-2,4,4000
1621000181,הפרשות סוציאליות ,64,64,68,-4,6,6000
1621000182,מיסים ועלויות ,35,35,36,-1,2,2000
1621000320,פיצויים ,0,0,0,0,0,0
1623000110,השכר הקובע ,136,136,151,-15,11,11000
1623000120,תוספות שאינן נכללות בשכר ,25,25,31,-6,24,24000
1623000130,שעות נוספות ,2,2,2,0,0,0
1623000140,החזר הוצאות ,49,49,60,-11,22,22000
1623000181,הפרשות סוציאליות ,30,30,38,-8,26,26000
1623000182,מיסים ועלויות ,16,16,18,-2,12,12000
1711000110,השכר הקובע ,198,198,260,-62,31,31000
1711000120,תוספות שאינן נכללות בשכר ,10,10,22,-12,120,120000
1711000130,שעות נוספות ,34,34,38,-4,11,11000
1711000140,החזר הוצאות ,88,88,86,2,2,2000
1711000181,הפרשות סוציאליות ,46,46,57,-11,23,23000
1711000182,מיסים ועלויות ,25,25,30,-5,20,20000
1711000320,פיצויים ,0,0,0,0,0,0
1714200110,השכר הקובע ,43,43,42,1,2,2000
1714200120,תוספות שאינן נכללות בשכר ,1,1,1,0,0,0
1714200130,שעות נוספות ,6,6,3,3,50,50000
1714200140,החזר הוצאות ,10,10,9,1,10,10000
1714200181,הפרשות סוציאליות ,7,7,7,0,0,0
1714200182,מיסים ועלויות ,5,5,4,1,20,20000
1721000110,השכר הקובע ,0,0,0,0,0,0
1728000110,השכר הקובע ,0,0,14,-14,0,0
1728000120,תוספות שאינן נכללות ב ,0,0,1,-1,0,0
1728000130,שעות נוספות ,0,0,0,0,0,0
1728000140,החזר הוצאות ,0,0,5,-5,0,0
1728000181,הפרשות סוציאליות ,0,0,3,-3,0,0
1728000182,מיסים ועלויות ,0,0,2,-2,0,0
1731000110,השכר הקובע ,404,404,434,-30,7,7000
1731000120,תוספות שאינן נכללות בשכר ,7,7,15,-8,114,114000
1731000130,שעות נוספות ,0,0,0,0,0,0
1731000140,החזר הוצאות ,107,107,109,-2,1,1000
1731000181,הפרשות סוציאליות ,106,106,112,-6,5,5000
1731000182,מיסים ועלויות ,39,39,42,-3,7,7000
1731000320,פיצויים ,0,0,0,0,0,0
1741000110,השכר הקובע ,0,0,0,0,0,0
1741000120,תוספות שאינן נלולות בש ,0,0,0,0,0,0
1741000130,שעות נוספות ,0,0,0,0,0,0
1741000140,החזר הוצאות ,0,0,0,0,0,0
1741000181,הפרשות סוציאליות ,0,0,0,0,0,0
1741000182,מיסים ועלויות ,0,0,0,0,0,0
1741000320,פיצויים ,0,0,0,0,0,0
1746000110,השכר הקובע ,110,110,125,-15,13,13000
1746000120,תוספות שאינן נכללות בשכר ,3,3,6,-3,100,100000
1746000130,שעות נוספות ,0,0,0,0,0,0
1746000140,החזר הוצאות ,31,31,29,2,6,6000
1746000181,הפרשות סוציאליות ,23,23,26,-3,13,13000
1746000182,מיסים ועלויות ,11,11,12,-1,9,9000
1746000320,פיצויים ,0,0,0,0,0,0
1823000110,השכר הקובע ,67,67,82,-15,22,22000
1823000120,תוספות שאינן נכללות בשכר ,0,0,1,-1,0,0
1823000130,שעות נוספות ,0,0,0,0,0,0
1823000140,החזר הוצאות ,0,0,0,0,0,0
1823000181,הפרשות סוציאליות ,5,5,7,-2,40,40000
1823000182,מיסים ועלויות ,5,5,6,-1,20,20000
1824000110,השכר הקובע ,0,0,0,0,0,0
1824000120,תוספות שאינן נכללות בש ,0,0,0,0,0,0
1824000140,החזר הוצאות ,0,0,0,0,0,0
1824000320,פיצויים ,0,0,0,0,0,0
1828100110,השכר הקובע ,46,46,93,-47,102,102000
1828100120,תוספות שאינן נכללות בש ,0,0,0,0,0,0
1828100130,שעות נספות ,0,0,0,0,0,0
1828100140,החזר הוצאות ,2,2,6,-4,200,200000
1828100181,הפרשות סוציאליות ,6,6,13,-7,116,116000
1828100182,מיסים ועלויות ,4,4,7,-3,75,75000
1828100320,פיצויים ,0,0,0,0,0,0
1828200110,השכר הקטבע ,0,0,0,0,0,0
1828200181,הפרשות סוציאליות ,0,0,0,0,0,0
1828200182,מיסים ועלויות ,0,0,0,0,0,0
1828300110,השכר הקובע ,0,0,21,-21,0,0
1828300130,סוצ ,0,0,1,-1,0,0
1828300181,הפרשות סוציאליות ,0,0,1,-1,0,0
1828300182,מסים ועלויות ,0,0,2,-2,0,0
1829100110,השכר הקובע ,65,65,71,-6,9,9000
1829100120,תוספות שאינן נכללות בשכר ,3,3,7,-4,133,133000
1829100130,שעות נוספות ,18,18,16,2,11,11000
1829100140,החזר הוצאות ,36,36,34,2,5,5000
1829100181,הפרשות סוציאליות ,14,14,15,-1,7,7000
1829100182,מיסים ועלויות ,9,9,10,-1,11,11000
1829100320,פיצויים ,0,0,0,0,0,0
1829300110,השכר הקובע ,6,6,23,-17,283,283000
1829300120,תוספות שאינן נכללות בשכר ,0,0,0,0,0,0
1829300130,שעות נוספות ,0,0,1,-1,0,0
1829300140,החזר הוצאות ,0,0,0,0,0,0
1829300181,הפרשים סוציאלים ,1,1,1,0,0,0
1829300182,מיסים ועלויות ,1,1,2,-1,100,100000
1853000110,השכר הקובע ,0,0,0,0,0,0
1853000120,תוספות שאינן נכללות בש ,0,0,0,0,0,0
1853000130,שעות נוספות ,0,0,0,0,0,0
1853000140,החזר הוצאות ,0,0,0,0,0,0
1853000181,הפרשות סוציאליות ,0,0,0,0,0,0
1853000182,מיסים ועלויות ,0,0,0,0,0,0
1853000320,פיצויים ,0,0,0,0,0,0
1913200110,השכר הקובע ,189,189,224,-35,18,18000
1913200120,תוספות שאינן נכללות בש ,8,8,16,-8,100,100000
1913200130,שעות נוספות ,28,28,35,-7,25,25000
1913200140,החזר הוצאות ,91,91,83,8,8,8000
1913200181,הפרשות סוציאליות ,46,46,53,-7,15,15000
1913200182,מיסים ועלויות ,24,24,27,-3,12,12000
1994000110,השכר הקובע ,0,0,14,-14,0,0
1994000120,תוספות שאינן נכללות בשכר ,3,3,3,0,0,0
1994000181,הפרשוצ סוציאליות ,0,0,0,0,0,0
1994000182,מסים ועלויות ,7,7,8,-1,14,14000
1994000310,פינסיה ,95,95,103,-8,8,8000
1610000000,מינהל כללי ,0,0,0,0,0,0
1611000000,הנהלה ומועצה ,0,0,0,0,0,0
1611100000,ראש הרשות המקומית וסגניו ,0,0,0,0,0,0
1611100441,ביטוח ,2,2,1,1,50,50000
1611100511,אירוח וכיבוד ,0,0,1,-1,0,0
1611100514,רכישת מתנות ,0,0,0,0,0,0
1611100521,השתלמויות ,27,27,30,-3,11,11000
1611100522,ספרות מקצועית ועתונים ,0,0,0,0,0,0
1611100523,דמי חבר באירגונים ,19,19,18,1,5,5000
1611100536,ביטוח תאונ' אישיות נבחרים ,0,0,0,0,0,0
1611100540,הוצאות תקשורת ,7,7,7,0,0,0
1611100550,הוצאות פרסום ,0,0,0,0,0,0
1611100580,הוצאות אחרות ,2,2,2,0,0,0
1611100780,הוצאות שונות ,0,0,0,0,0,0
1611100810,תרומות ראש המועצה ,0,0,0,0,0,0
1612000000,מבקר הרשות ,0,0,0,0,0,0
1612000521,השתלמויות ,0,0,0,0,0,0
1612000522,ספרות מקצועית ועתונים ,0,0,0,0,0,0
1612000523,דמי חבר באירגונים ,0,0,0,0,0,0
1612000930,רכישת ציוד יסודי ,0,0,0,0,0,0
1613000000,מזכירות ,0,0,0,0,0,0
1613000431,חשמל ,50,50,45,5,10,10000
1613000432,מים ,30,30,42,-12,40,40000
1613000433,חומרי נקיון ,0,0,0,0,0,0
1613000434,שרותי נקיון ,25,25,27,-2,8,8000
1613000441,ביטוח ,0,0,29,-29,0,0
1613000450,רהוט ואחזקתו ,0,0,0,0,0,0
1613000470,ציוד משרדי מתכלה ,25,25,61,-36,144,144000
1613000510,כיבוד ללא עודפות ,23,23,25,-2,8,8000
1613000511,אירוח וכיבוד ,10,10,11,-1,10,10000
1613000514,רכישת מתנות ,25,25,32,-7,28,28000
1613000521,השתלמויות ,20,20,8,12,60,60000
1613000522,ספרות מקצועית ועותנים ,3,3,4,-1,33,33000
1613000523,דמי חבר באירגונים ,35,35,33,2,5,5000
1613000540,הוצאות תקשורת ,90,90,116,-26,28,28000
1613000550,הוצאות פרסום ,30,30,43,-13,43,43000
1613000560,הוצאות משרדיות ,0,0,0,0,0,0
1613000580,הוצאות ארגוניות/אחרות ,17,17,23,-6,35,35000
1613000720,חומרים ,1,1,2,-1,100,100000
1613000730,טיוטה 06-743-12 ,0,0,0,0,0,0
1613000731,דלק ושמנים ,40,40,48,-8,20,20000
1613000732,תיקונים ,10,10,19,-9,90,90000
1613000733,רישוי וביטוח ,15,15,11,4,26,26000
1613000743,רכישת כלים ומכשור ,1,1,4,-3,300,300000
1613000750,עבודות קבלניות ,50,50,76,-26,52,52000
1613000751,שמירה בנין המועצה ,95,95,99,-4,4,4000
1613000780,הוצאות שונות ,9,9,8,1,11,11000
1613000810,השתתפות ותרומות ,0,0,0,0,0,0
1613000930,רכישת ציוד יסודי ,20,20,20,0,0,0
1613000970,תש' הוצאות עודפות ,25,25,23,2,8,8000
1614000000,הסברה ויחסי ציבור ,0,0,0,0,0,0
1614000523,דמי חבר באירגונים ,0,0,0,0,0,0
1615000000,מנגנון ,0,0,0,0,0,0
1615000521,השתלמויות ,0,0,0,0,0,0
1616000000,"או""ש והדרכה ",0,0,0,0,0,0
1616000980,הוצאות אחרות ,0,0,0,0,0,0
1617000000,שרות משפטי ,0,0,0,0,0,0
1617000750,עבודות קבלניות ,110,110,111,-1,0,0
1617000751,הוצ' מישפטיות ,100,100,48,52,52,52000
1619000750,בחירות 8002 ,0,0,0,0,0,0
1621000000,הגזברות ,0,0,0,0,0,0
1621000521,השתלמויות ,5,5,4,1,20,20000
1621000522,ספרות מקצועית ,3,3,3,0,0,0
1621000523,דמי חבר באירגונים ,0,0,2,-2,0,0
1621000540,הוצאות תקשורת ,3,3,3,0,0,0
1621000560,הוצאות משרדיות ,0,0,0,0,0,0
1621000743,רכישת כלים ומכשור ,0,0,0,0,0,0
1621000750,עבודות קבלניות ,12,12,140,-128,66,66000
1621000780,הוצאות שונות ,0,0,0,0,0,0
1621000930,רכישת ציוד יסודי ,0,0,0,0,0,0
1621300000,הנהלת חשבונות ,0,0,0,0,0,0
1621300580,הוצאות אורגניות/אחרות ,0,0,0,0,0,0
1621300750,עבודות קבלניות ,465,465,470,-5,1,1000
1621700570,מיכון ועיבוד ניתונים ,350,350,348,2,0,0
1623000000,שומה וגביה ,0,0,0,0,0,0
1623000521,השתלמויות ,0,0,0,0,0,0
1623000540,טלפון ,0,0,1,-1,0,0
1623000580,הוצאות אורגניות/אחרות ,0,0,0,0,0,0
1623000750,עבודות קבלניות ,100,100,100,1,1,1000
1623000930,רכישת ציוד יסודי ,0,0,0,0,0,0
1623100750,עבודות קבלניות ,0,0,0,0,0,0
1631000000,הוצאות מימון ,0,0,0,0,0,0
1632000000,הוצאות מימון ,0,0,0,0,0,0
1640000000,פרעון מלוות ,0,0,0,0,0,0
1648100000,פרעון מלוות אחר ,0,0,0,0,0,0
1649100000,פרעון מלוות מים וביוב ,0,0,0,0,0,0
1711000000,תברואה ,0,0,0,0,0,0
1711000521,השתלמויות ,1,1,11,-10,0,0
1711000523,דמי חבר באירגונים ,1,1,0,1,100,100000
1711000540,הוצאות תקשורת ,0,0,1,-1,0,0
1711000560,הוצאות משרדיות ,0,0,0,0,0,0
1711000580,הוצאות ארגוניות/אחרות ,0,0,0,0,0,0
1711000700,רכב מיול ,0,0,0,0,0,0
1711000720,חומרים-תברואה ,10,10,0,10,100,100000
1711000730,רכב מיול 42-816-27 ,0,0,0,0,0,0
1711000731,דלק ושמנים ,30,30,29,1,3,3000
1711000732,תיקונים ,10,10,10,0,0,0
1711000733,רישוי וביטוח ,5,5,2,3,60,60000
1711000743,רכישת כלים ומכשור ,18,18,20,-2,11,11000
1711000750,עבודות קבלניות ,45,45,32,13,28,28000
1711000930,רכישת ציוד יסודי ,0,0,0,0,0,0
1712200000,ניקוי רחובות ,0,0,0,0,0,0
1712200720,חומרים ,0,0,0,0,0,0
1712200730,מחפרון B.C.J ,0,0,0,0,0,0
1712200731,דלק ושמנים בובקט ,90,90,43,47,52,52000
1712200732,בובקט-תיקונים ,17,17,23,-6,35,35000
1712200733,רישוי וביטוח-בובקט ,25,25,9,16,64,64000
1712200743,רכישת כלים ומכשור ,0,0,0,0,0,0
1712200750,עבודות קבלניות ,0,0,0,0,0,0
1712200930,רכישת ציוד יסודי ,0,0,0,0,0,0
1712300000,אסוף וביעור אשפה ,0,0,0,0,0,0
1712300720,חומרים ,0,0,0,0,0,0
1712300750,עבודות קבלניות ,720,720,996,-276,38,38000
1713000000,פקוח תברואי ,0,0,0,0,0,0
1713100000,מינהל פיקוח תברואי ,0,0,0,0,0,0
1714200523,דמי חבר באירגונים ,0,0,0,0,0,0
1714200720,חומרים ,0,0,0,0,0,0
1714200750,עבודות קבלניות ,0,0,0,0,0,0
1714300000,מלחמה בכלבת ,0,0,0,0,0,0
1714300720,חומרים ,1,1,0,1,100,100000
1715000000,תברואה מונעת ,0,0,0,0,0,0
1715100000,מינהל תברואה מונעת ,0,0,0,0,0,0
1715200720,חומרים ,0,0,0,0,0,0
1715200743,רכישת כלים ומכשור ,0,0,0,0,0,0
1715200750,עבודות קבלניות ,0,0,0,0,0,0
1715300000,הדברת מזיקים ,0,0,0,0,0,0
1715300521,השתלמויות ,0,0,0,0,0,0
1715300720,חומרים ,80,80,56,24,30,30000
1715300743,רכישת כלים ומכשור ,0,0,0,0,0,0
1715300750,עבודות קבלניות ,0,0,0,0,0,0
1721000521,השתלמות ,0,0,0,0,0,0
1721000523,דמי חבר בארגונים ,0,0,0,0,0,0
1722000750,עבודות קבלניות ,0,0,0,0,0,0
1723000830,"השתת' הבג""א ",46,46,47,-1,2,2000
1724000580,הוצאות ארגוניות/אחרות ,0,0,0,0,0,0
1724000830,השתת' באיגוד ערים ,200,200,195,5,2,2000
1725000930,רכישת ציוד יסודי ,0,0,0,0,0,0
1725100720,"חומרים-זה""ב ",0,0,0,0,0,0
1725100750,עבודות קבלניות ,0,0,0,0,0,0
1725100930,רכישת ציוד יסודי ,0,0,0,0,0,0
1726100750,משק לשעת חרום ,0,0,0,0,0,0
1728000000,עיר ללא אלימות ,0,0,0,0,0,0
1730000000,תכנון ובנין עיר ,0,0,0,0,0,0
1731000000,משרד מהנדס הרשות ,0,0,0,0,0,0
1731000441,ביטוח ,0,0,0,0,0,0
1731000521,השתלמויות ,1,1,1,0,0,0
1731000522,ספרות מקצועית ,0,0,0,0,0,0
1731000523,דמי חבר באירגונים ,1,1,1,0,0,0
1731000540,הוצאות תקשורת ,0,0,0,0,0,0
1731000550,הוצאות פרסום ,0,0,0,0,0,0
1731000560,הוצאות משרדיות ,0,0,0,0,0,0
1731000750,עבודות קבלניות ,120,120,242,-122,101,101000
1731000751,"שכ""ט מהנדס ",0,0,0,0,0,0
1731000930,רכישת ציוד יסודי ,10,10,4,6,60,60000
1732100000,תכנון כללי ,0,0,0,0,0,0
1732100560,הוצאות משרדיות ,0,0,0,0,0,0
1732100750,עבודות קבלניות ,10,10,3,7,70,70000
1732200000,תוכניות אב ,0,0,0,0,0,0
1732200750,תכנון עיר ,0,0,0,0,0,0
1732300000,מדידות ,0,0,0,0,0,0
1732300750,עבודות קבלניות ,0,0,0,0,0,0
1733000000,רישוי ופקוח על הבניה ,0,0,0,0,0,0
1733100000,אגרות רשיונות בניה ,0,0,0,0,0,0
1733400760,ועדה לתכנון בניה שמעונים ,586,586,502,84,14,14000
1734000000,מדידות ,0,0,0,0,0,0
1735000000,תכנית אב ,0,0,0,0,0,0
1740000000,נכסים צבוריים-ש.פ.ה ,0,0,0,0,0,0
1741000000,מינהל נכסים ציבוריים ,0,0,0,0,0,0
1741000470,ציוד משרדי מתכלה ,0,0,0,0,0,0
1741000521,השתלמויות ,0,0,0,0,0,0
1741000523,דמי חבר באירגונים ,0,0,0,0,0,0
1741000540,הוצאות תקשורת ,0,0,0,0,0,0
1741000720,חומרים ,0,0,0,0,0,0
1741000743,רכישת כלים ומכשור ,0,0,0,0,0,0
1741000750,עבודות קבלניות ,0,0,0,0,0,0
1742000000,דרכים ומדרכות ,0,0,0,0,0,0
1742000750,עבודות קבלניות ,0,0,0,0,0,0
1742100000,אחזקת כבישים עורקיים ,0,0,0,0,0,0
1742100720,חומרים ,0,0,0,0,0,0
1742100750,עבודות קבלניות ,0,0,0,0,0,0
1742200000,אחז כבישים פנימיים ומדרכו ,0,0,0,0,0,0
1742200720,חומרים ,0,0,0,0,0,0
1743000000,תאורת רחובות ,0,0,0,0,0,0
1743000431,חשמל ,250,250,250,0,0,0
1743000720,חומרים ,0,0,0,0,0,0
1743000750,עבודות קבלניות ,60,60,7,53,88,88000
1743000771,חשמל לפעולות ,0,0,0,0,0,0
1744000000,בטיחות בדרכים ,0,0,0,0,0,0
1744000470,"ציוד משרדי-זה""ב ",0,0,0,0,0,0
1744000750,עבודות קבלניות ,0,0,0,0,0,0
1744100000,תחזוקת רמזורים ואיי תנועה ,0,0,0,0,0,0
1744400720,חומרים ,10,10,0,10,100,100000
1744400750,עבודות קבלניות ,55,55,67,-12,21,21000
1744400930,רכישת ציוד יסודי ,0,0,0,0,0,0
1744400950,הוצאות תכנון ,0,0,0,0,0,0
1745000000,תיעול וניקוז ,0,0,0,0,0,0
1745000720,חומרים ,0,0,0,0,0,0
1745000741,השכרת כלים מכשירים וציוד ,0,0,0,0,0,0
1745000743,רכישת כלים ומכשור ,0,0,0,0,0,0
1745000750,עבודות קבלניות ,0,0,0,0,0,0
1745000830,השתתפות ברשות הנקוז ,80,80,80,0,0,0
1745300000,ריקון בורות שופכין ,0,0,0,0,0,0
1746000000,גנים ונטיעות ,0,0,0,0,0,0
1746000521,השתלמויות ,2,2,1,1,50,50000
1746000523,דמי חבר באירגונים ,0,0,0,0,0,0
1746000540,הוצאות תקשורת ,0,0,0,0,0,0
1746000720,חומרים ,0,0,0,0,0,0
1746000743,רכישת כלים ומכשור ,4,4,4,0,0,0
1746000750,עבודות קבלניות ,62,62,64,-2,3,3000
1746000930,רכישת ציוד יסודי ,0,0,0,0,0,0
1746100000,גינות ציבוריים ,0,0,0,0,0,0
1746100432,מים ,110,110,179,-69,62,62000
1746100521,השתלמויות ,0,0,0,0,0,0
1746100720,חומרים ,0,0,0,0,0,0
1746100730,מכסחת דשא 843-51 ,0,0,0,0,0,0
1746100731,דלק ושמנים ,1,1,1,0,0,0
1746100732,תיקונים ,2,2,0,2,100,100000
1746100733,רישוי וביטוח ,3,3,1,2,66,66000
1746100741,השכרת כלים מכשירים וציוד ,0,0,0,0,0,0
1746100743,רכישת כלים ומכשור ,0,0,0,0,0,0
1746100750,עבודות קבלניות ,0,0,0,0,0,0
1746100930,רכישת ציוד יסודי ,0,0,0,0,0,0
1746400000,ריהוט רחוב ומתקני משחקים ,0,0,0,0,0,0
1748000000,בתי עלמין ,0,0,0,0,0,0
1750000000,חגיגות מבצעים וארועים ,0,0,0,0,0,0
1751000000,חגיגות יום העצמאות ,0,0,0,0,0,0
1751000580,הוצאות ארגוניות/אחרות ,0,0,0,0,0,0
1751000720,חומרים ,0,0,0,0,0,0
1751000741,השכרת כלים ,0,0,0,0,0,0
1751000750,עבודות קבלניות ,0,0,0,0,0,0
1752000000,חגיגות וטכסים אחרים ,0,0,0,0,0,0
1752000580,הוצאות ארגוניות/אחרות ,0,0,0,0,0,0
1752000720,חומרים ,0,0,0,0,0,0
1752000743,רכישת כלים ומכשור ,0,0,0,0,0,0
1752000750,עבודות קבלניות ,0,0,0,0,0,0
1753000000,פעולות אימוץ ,0,0,0,0,0,0
1753000810,הועד למען החייל ,0,0,0,0,0,0
1753000811,הועד למען השוטר המרחבי ,0,0,0,0,0,0
1756000513,נסיעות ,0,0,0,0,0,0
1756000580,כנסים וארועים בינלאומיים ,3,3,3,0,0,0
1761000000,השת.במוסדות כלליים ,0,0,0,0,0,0
1762000000,השתת בועדים מקומים ,0,0,0,0,0,0
1765000750,עבודות קבלניות ,0,0,0,0,0,0
1767000000,בטוח אלמנטרי לרשות ,0,0,0,0,0,0
1767000441,ביטוח ,82,82,87,-5,6,6000
1773100810,הון מניות ,0,0,0,0,0,0
1773200810,הלוואת בעלים ןשטרי הון ,0,0,0,0,0,0
1811000000,מינהל חינוך ,0,0,0,0,0,0
1812200000,גני ילדים-חובה ,0,0,0,0,0,0
1812300000,גני ילדים-טרום חובה ,0,0,0,0,0,0
1813200000,"בי""ס יסודי חורה א' ",0,0,0,0,0,0
1813201000,"בי""ס יסודי אלעטאונה ",0,0,0,0,0,0
1813202000,"בי""ס יסודי חורה ב'-אלמג'ד ",0,0,0,0,0,0
1813203000,"בי""ס יסודי אלביאדר ",0,0,0,0,0,0
1813300000,"בי""ס חינוך מיוחד ",0,0,0,0,0,0
1813301000,חינוך מיוחד ללא תקן ,0,0,0,0,0,0
1813302000,"בי""ס אלופאא לאוטיסטים ",0,0,0,0,0,0
1813600000,"מרכז מתי""א ",0,0,0,0,0,0
1814000000,"בי""ס חט""ב חורה ",0,0,0,0,0,0
1814001000,"בי""ס אלנור-עתיד ",0,0,0,0,0,0
1815200000,"ביס""ס תיכון - עמל ",0,0,0,0,0,0
1815201000,"בי""ס תיכון - עתיד אלנור ",0,0,0,0,0,0
1815202000,"בי""ס תיכון - סכנין ",0,0,0,0,0,0
1815203000,"בי""ס תיכון - אלעהד ",0,0,0,0,0,0
1815204000,"בי""ס תיכון אלסלאם ",0,0,0,0,0,0
1816800000,קרן מילגות עירונית ,0,0,0,0,0,0
1817300000,שרות פסיכולוגי חינוכי ,0,0,0,0,0,0
1817400000,שרותי בריאות לתלמיד ,0,0,0,0,0,0
1817500000,בטוח תלמידים ,0,0,0,0,0,0
1817600000,רווחה חינוכית ,0,0,0,0,0,0
1817800000,הסעת ילדים ,0,0,0,0,0,0
1817900000,"שרותים נוספים לבתי""ס וגני ",0,0,0,0,0,0
1818000000,חינוך מבוגרים ,0,0,0,0,0,0
1818200000,אוניברסיטאות ,0,0,0,0,0,0
1822000000,פעולות תרבות ,0,0,0,0,0,0
1822000431,חשמל ,0,0,0,0,0,0
1822000511,אירוח וכיבוד ,0,0,0,0,0,0
1822000521,השתלמויות ,0,0,0,0,0,0
1822000550,הוצאות פרסום ,0,0,0,0,0,0
1822000580,הוצאות ארגוניות/אחרות ,0,0,0,0,0,0
1822000750,עבודות קבלניות ,0,0,64,-64,0,0
1823000000,סיפריה עירונית ,0,0,0,0,0,0
1823000431,חשמל ,35,35,27,8,22,22000
1823000432,מים ,18,18,31,-13,72,72000
1823000433,חומרי נקיון ,0,0,0,0,0,0
1823000434,שרותי ניקיון-סיפריה ,13,13,13,0,0,0
1823000470,ציוד משרדי-סיפריה ,0,0,0,0,0,0
1823000521,השתלמויות-ספריה ,2,2,2,0,0,0
1823000540,הוצאות תקשורת ,2,2,3,-1,50,50000
1823000560,הוצאות משרדיות-סיפריה ,0,0,0,0,0,0
1823000580,הוצאות ארגוניות שונות ,0,0,0,0,0,0
1823000720,חומרים-סיפריה ,0,0,0,0,0,0
1823000743,"כלים, מכשירים וציוד ",0,0,0,0,0,0
1823000750,עבודות קבלניות-סיפריה ,7,7,4,3,42,42000
1823000751,שמירה ,8,8,14,-6,75,75000
1823000780,הוצאות שונות-סיפריה ,0,0,0,0,0,0
1823000930,ציוד יסודי-סיפריה ,0,0,0,0,0,0
1824000000,"מתנ""סים ",0,0,0,0,0,0
1824000410,"דמי הוון מתנ""ס ",0,0,0,0,0,0
1824000431,חשמל ,23,23,20,3,13,13000
1824000432,מים ,35,35,34,1,2,2000
1824000433,חומרי נקיון ,0,0,0,0,0,0
1824000434,שירותי נקיון ,12,12,15,-3,25,25000
1824000470,ציוד משרדי מתכלה ,0,0,0,0,0,0
1824000521,השתלמויות ,0,0,0,0,0,0
1824000540,"הוצאות תקשורת מתנ""ס ",2,2,2,0,0,0
1824000750,עבודות קבלניות ,4,4,32,-28,700,700000
1824000780,הוצאות שונות ,0,0,0,0,0,0
1824000810,השתתפות ותרומות ,300,300,456,-156,52,52000
1824000811,"החזר הוצאות למתנ""ס ",50,50,0,50,100,100000
1824000930,רכישת ציוד יסודי ,0,0,0,0,0,0
1826400000,מועדון לאשה ,0,0,0,0,0,0
1826400410,"מועדון לאישה-שכ""ד ",30,30,0,30,100,100000
1826400431,חשמל ,0,0,0,0,0,0
1826400470,ציוד משרדי מתכלה ,0,0,0,0,0,0
1826400580,הוצאות אורגוניות/שונות ,0,0,0,0,0,0
1826400750,עבודות קבלניות-מ.נשים ,0,0,0,0,0,0
1828100000,מינהל הנוער ,0,0,0,0,0,0
1828100750,עב' קבלניות-מינהל הנוער ,0,0,2,-2,0,0
1828200810,מרחב פתוח נוער ,0,0,0,0,0,0
1828300000,חוגי נוער ,0,0,0,0,0,0
1828300470,ציוד משרדי מתכלה ,0,0,0,0,0,0
1828300511,אירוח וכיבוד ,0,0,0,0,0,0
1828300514,רכישת מתנות ,0,0,0,0,0,0
1828300580,הוצאות ארגוניות/אחרות ,0,0,0,0,0,0
1828300710,הובלות והסעות קבלניות ,0,0,0,0,0,0
1828300720,חומרים ,0,0,0,0,0,0
1828300750,עבודות קבלניות ,0,0,0,0,0,0
1828300780,הוצאות שונות ,0,0,0,0,0,0
1828300810,השתתפות בחוגי העשרה ,0,0,0,0,0,0
1828400000,קיטנות נוער ,0,0,0,0,0,0
1828400470,ציוד משרדי מתכלה ,0,0,0,0,0,0
1828400511,אירוח וכיבוד ,0,0,0,0,0,0
1828400560,הוצאות משרדיות ,0,0,0,0,0,0
1828400580,הוצאות ארגוניות/אחרות ,0,0,0,0,0,0
1828400720,חומרים ,0,0,0,0,0,0
1828400743,רכישת כלים ומכשור ,0,0,0,0,0,0
1828400750,עבודות קבלניות ,0,0,0,0,0,0
1828400780,הוצאות שונות ,0,0,0,0,0,0
1828400930,רכישת ציוד יסודי ,0,0,0,0,0,0
1829000000,ספורט ,0,0,0,0,0,0
1829100000,מינהל הספורט ,0,0,0,0,0,0
1829100441,ביטוח ,0,0,0,0,0,0
1829100511,אירוח וכיבוד ,1,1,0,1,100,100000
1829100521,השתלמויות-ספורט ,7,7,11,-4,57,57000
1829100522,ספרות מקצועית ,0,0,0,0,0,0
1829100523,דמי חבר בארגונים-ספורט ,0,0,0,0,0,0
1829100540,הוצאות תקשורת ,0,0,0,0,0,0
1829100580,הוצ' אירגוניות ,2,2,0,2,100,100000
1829200431,חשמל ,5,5,0,5,100,100000
1829200432,מים ,20,20,12,8,40,40000
1829200434,שרותי נקיון ,12,12,3,9,75,75000
1829300000,פעולות ספורט ,0,0,0,0,0,0
1829300522,ספרות מקצועית ,0,0,0,0,0,0
1829300580,הוצאות ארגוניות/אחרות ,20,20,23,-3,15,15000
1829300720,חומרים ,0,0,0,0,0,0
1829300743,רכישת כלים ומכשור ,20,20,5,15,75,75000
1829300750,עבודות קבלניות ,16,16,22,-6,37,37000
1829300780,הוצאות שונות ,0,0,0,0,0,0
1829300810,השתת' בתקציב פעלות ספו ,0,0,0,0,0,0
1829300930,רכישת ציוד יסודי ,0,0,0,0,0,0
1829300980,הוצאות אחרות ,0,0,0,0,0,0
1829900000,ארגוני ספורט ,0,0,0,0,0,0
1830000000,בריאות ,0,0,0,0,0,0
1832000000,מרפאות ,0,0,0,0,0,0
1832200000,מרפאות כלליות ,0,0,0,0,0,0
1832200720,חומרים ,0,0,0,0,0,0
1832200750,עבודות קבלניות ,0,0,0,0,0,0
1832200930,רכישת ציוד יסודי ,0,0,0,0,0,0
1832400000,תחנות אם וילד ,0,0,0,0,0,0
1832400410,שכר דירה ודמי חכירה ,0,0,0,0,0,0
1832400431,חשמל ,15,15,14,1,6,6000
1832400432,מים ,33,33,41,-8,24,24000
1832400433,חומרי נקיון ,0,0,0,0,0,0
1832400434,שרותי נקיון ,24,24,24,0,0,0
1832400540,הוצאות תקשורת ,0,0,0,0,0,0
1832400720,חומרים ,0,0,0,0,0,0
1832400743,רכישת כלים מכשירים וציוד ,0,0,0,0,0,0
1832400750,עבודות קבלניות ,0,0,0,0,0,0
1832400930,רכישת ציוד יסודי ,0,0,0,0,0,0
1833300520,ספרות מקצועית ועתנות ,0,0,0,0,0,0
1833300560,הוצאות משרדיות ,0,0,0,0,0,0
1833300580,הוצאות ארגוניות שונות ,0,0,0,0,0,0
1833300753,הזנה ,0,0,0,0,0,0
1835000000,מוסדות בריאות אחרים ,0,0,0,0,0,0
1835000720,חומרים ,0,0,0,0,0,0
1835000740,כלים מכשירים וציוד ,0,0,0,0,0,0
1835000750,עבודות קבלניות ,0,0,0,0,0,0
1836200780,השתתפות בנ.ט.נ ,0,0,0,0,0,0
1837000980,הוצאות אחרות ,0,0,0,0,0,0
1841000000,מינהל הרווחה ,0,0,0,0,0,0
1842000000,רווחת הפרט והמשפחה ,0,0,0,0,0,0
1843000000,שרותים לילד ולנוער ,0,0,0,0,0,0
1844000000,שירותים לזקן ,0,0,0,0,0,0
1845000000,שרותים למפגר ,0,0,0,0,0,0
1846000000,שרותי שיקום ,0,0,0,0,0,0
1847000000,שרותי תיקון ,0,0,0,0,0,0
1848000000,עבודות קהילתיות ,0,0,0,0,0,0
1853000000,שרותי דת למוסלמים ,0,0,0,0,0,0
1853000431,חשמל ,30,30,27,3,10,10000
1853000432,מים ,50,50,26,24,48,48000
1853000720,חומרים ,0,0,0,0,0,0
1853000750,עבודות קבלניות ,0,0,128,-128,0,0
1853000810,השתת ותרומות למוסות דת ,0,0,0,0,0,0
1859000810,תמיכות למוסדות ,0,0,0,0,0,0
1879000580,מבצע איכות הסביבה ,0,0,0,0,0,0
1879000750,עבודות קבלניות ,0,0,59,-59,0,0
1879000810,איכות הסביבה ,0,0,0,0,0,0
1911000521,השתלמויות ,0,0,0,0,0,0
1913000000,אספקה והנדסת מים ,0,0,0,0,0,0
1913100750,עבודות קבלניות ,0,0,0,0,0,0
1913100980,הוצאות אחרות ,0,0,0,0,0,0
1913200521,השתלמויות-מים ,7,7,7,0,0,0
1913200720,חומרים ,1,1,25,-24,400,400000
1913200743,רכישת כלים ומכשור ,60,60,43,17,28,28000
1913200750,עבודות קבלניות ,50,50,95,-45,90,90000
1913200780,הוצאות שונות ,1,1,1,0,0,0
1913200980,הוצאות_אחרות ,0,0,0,0,0,0
1970000780,אגרת ביוב מ.מ.י ,0,0,0,0,0,0
1972000000,פרעון מלוות מים וביוב ,0,0,0,0,0,0
1972000780,הוצאות שונות ,0,0,0,0,0,0
1913100720,קנית מים ממקורות ,4601,4601,4645,-44,0,0
1811000110,השכר הקובע ,321,321,353,-32,9,9000
1811000120,תוספות שאינן נכללות בשכר ,9,9,17,-8,88,88000
1811000130,שעות נוספות ,32,32,41,-9,28,28000
1811000140,החזר הוצאות ,95,95,77,18,18,18000
1811000181,הפרשות סוציאליות ,72,72,80,-8,11,11000
1811000182,מיסים ועלויות ,34,34,39,-5,14,14000
1812200110,השכר הקובע ,897,897,989,-92,10,10000
1812200120,תוספות שאינן נכללות בשכר ,99,99,91,8,8,8000
1812200130,שעות נוספות ,0,0,0,0,0,0
1812200140,החזר הוצאות ,55,55,40,15,27,27000
1812200181,הפרשות סוציאליות ,200,200,215,-15,7,7000
1812200182,מיסים ועלויות ,79,79,84,-5,6,6000
1812200320,פיצויים ,0,0,3,-3,0,0
1812201110,השכר הקובע מ.מ. ,95,95,163,-68,71,71000
1812201120,תוספות שאינן נכללות בשכר ,1,1,0,1,100,100000
1812201130,שעות נוספות ,0,0,0,0,0,0
1812201140,החזר הוצאות ,1,1,1,0,0,0
1812201181,סוציאליות מ.מ. ,4,4,6,-2,50,50000
1812201182,מסים מ.מ. ,7,7,12,-5,71,71000
1812300110,השכר הקובע ,755,755,864,-109,14,14000
1812300120,תוספות שאינן נכללות בש ,35,35,32,3,8,8000
1812300130,שעות נוספות ,0,0,0,0,0,0
1812300140,החזר הוצאות ,38,38,39,-1,2,2000
1812300181,הפרשות סוציאליות ,184,184,201,-17,9,9000
1812300182,מיסים ועלויות ,62,62,70,-8,12,12000
1812300320,פיצויים ,0,0,0,0,0,0
1812301110,השכר הקובע מ.מ. ,129,129,115,14,10,10000
1812301120,תוספות שאינן נכללות ב ,0,0,0,0,0,0
1812301140,החזר הוצאות ,2,2,0,2,100,100000
1812301181,סוציאליות מ.מ. ,5,5,5,0,0,0
1812301182,מסים מ.מ. ,10,10,9,1,10,10000
1812302110,השכר הקובע - ט.חובה מעגן ,0,0,8,-8,0,0
1812302120,תוספות שאינן נכללות בשכר הקו,0,0,0,0,0,0
1812302130,שעות נוספות ,0,0,0,0,0,0
1812302140,החזר הוצאות ,0,0,0,0,0,0
1812302181,הפרשות סוציאליות ,0,0,0,0,0,0
1812302182,מסים ועלויות ,0,0,1,-1,0,0
1813200110,השכר הקובע ,169,169,164,5,2,2000
1813200120,תוספות שאינן נכללות_בש ,5,5,5,0,0,0
1813200130,שעות נוספות ,0,0,0,0,0,0
1813200140,החזר הוצאות ,7,7,27,-20,285,285000
1813200181,הפרשות סוציאליות ,30,30,33,-3,10,10000
1813200182,מיסים ועלויות ,14,14,15,-1,7,7000
1813200320,פיצויים ,0,0,0,0,0,0
1813201110,השכר הקובע ,193,193,210,-17,8,8000
1813201120,תוספות שאינן נכללות בשכר ,6,6,13,-7,116,116000
1813201130,שעות נוספות ,6,6,6,0,0,0
1813201140,החזר הוצאות ,4,4,4,0,0,0
1813201181,הפרשות סוציאליות ,36,36,40,-4,11,11000
1813201182,מיסים ועלויות ,17,17,18,-1,5,5000
1813201320,פיצויים ,0,0,0,0,0,0
1813202110,השכר הקבוע ,315,315,298,17,5,5000
1813202120,עוספות שאינן נכללות בש ,13,13,13,0,0,0
1813202130,שעות נוספות ,0,0,0,0,0,0
1813202140,החזר הוצאות ,39,39,14,25,64,64000
1813202181,הפרשות סוציאליות ,77,77,72,5,6,6000
1813202182,מיסים ועלויות ,28,28,24,4,14,14000
1813203110,השכר הקובע ,174,174,185,-11,6,6000
1813203120,תוספות שאינן נכללות בשכר ,12,12,12,0,0,0
1813203130,שעות נוספות ,0,0,10,-10,0,0
1813203140,החזר הוצאות ,9,9,8,1,11,11000
1813203181,הפרשות סוציאליות ,37,37,40,-3,8,8000
1813203182,מיסים ועלויות ,15,15,16,-1,6,6000
1813203320,פיצויים ,0,0,0,0,0,0
1813204110,השכר הקובע ,137,137,158,-21,15,15000
1813204120,תוספות שאינן נכללות בשכר ,7,7,3,4,57,57000
1813204130,שעות נוספות ,1,1,0,1,100,100000
1813204140,החזר הוצאות ,18,18,19,-1,5,5000
1813204181,הפרשות סוציאליות ,36,36,39,-3,8,8000
1813204182,מיסים ועלויות ,12,12,14,-2,16,16000
1813204320,פיצויים ,0,0,0,0,0,0
1813205110,השכר הקובע ,117,117,145,-28,23,23000
1813205120,תוספות שאינן נכללות ב ,7,7,11,-4,57,57000
1813205130,שעות נוספות ,1,1,0,1,100,100000
1813205140,החזר הוצאות ,18,18,24,-6,33,33000
1813205181,הפרשות סוציאליות ,36,36,22,14,38,38000
1813205182,מיסים ועלויות ,12,12,14,-2,16,16000
1813205320,פיצויים ,0,0,0,0,0,0
1813300110,השכר הקובע ,801,801,921,-120,14,14000
1813300120,תוספות שאינן נכללות בשכר ,18,18,20,-2,11,11000
1813300130,שעות נוספות ,0,0,1,-1,0,0
1813300140,החזר הוצאות ,34,34,35,-1,2,2000
1813300181,הפרשות סוציאליות ,186,186,213,-27,14,14000
1813300182,מיסים ועלויות ,64,64,73,-9,14,14000
1813300320,פיצויים ,0,0,4,-4,0,0
1813301110,השכר הקובע ,237,237,404,-167,70,70000
1813301120,תוספות שאינן נכללות ב ,0,0,0,0,0,0
1813301130,שעות נוספות ,0,0,0,0,0,0
1813301140,החזר הוצאות ,7,7,11,-4,57,57000
1813301181,הפרשות סוציאליות ,8,8,15,-7,87,87000
1813301182,מיסים ועלויות ,18,18,31,-13,72,72000
1813301320,פצויי פיטורין ,0,0,0,0,0,0
1813302110,השכר הקובע - אלופאא ,0,0,112,-112,0,0
1813302120,תוספות שאינן נכללות - אלופאא,0,0,1,-1,0,0
1813302130,שעות נוספות - אלופאא ,0,0,2,-2,0,0
1813302140,החזר הוצאות - אלופאא ,0,0,4,-4,0,0
1813302181,הפרשות סוציאליות - אלופאא ,0,0,19,-19,0,0
1813302182,מיסים ועלויות - אלופאא ,0,0,9,-9,0,0
1813302320,פיצויים - אלופאא ,0,0,0,0,0,0
1813400110,השכר הקובע ,30,30,9,21,70,70000
1813400120,תוספות שאינן נכללות בשכר הקו,5,5,0,5,100,100000
1813400130,שעות נוספות ,0,0,6,-6,0,0
1813400140,החזר הוצאות ,5,5,0,5,100,100000
1813400181,הפרשים סוציאלים ,5,5,1,4,80,80000
1813400182,מיסים ועלויות ,5,5,1,4,80,80000
1813600110,השכר הקובע ,57,57,56,1,1,1000
1813600120,תוספות שאינן נכללות ב ,1,1,1,0,0,0
1813600130,שעות נוספות ,0,0,0,0,0,0
1813600140,החזר הוצאות ,2,2,2,0,0,0
1813600181,הפרשות סוציאליות ,8,8,13,-5,62,62000
1813600182,מסים ועלויות ,5,5,4,1,20,20000
1814000110,השכר הקובע ,0,0,0,0,0,0
1814000120,תוספות שאינן נכללות בשכר ,0,0,0,0,0,0
1814000130,שעות נוספות ,0,0,0,0,0,0
1814000140,החזר הוצאות ,0,0,0,0,0,0
1814000181,הפרשות סוציאליות ,0,0,0,0,0,0
1814000182,מיסים ועלויות ,0,0,0,0,0,0
1814000320,פיצויים ,0,0,0,0,0,0
1814001110,השכר הקובע ,0,0,0,0,0,0
1814001120,תוספות שאינן נכללות בשכר ,0,0,0,0,0,0
1814001130,שעות נוספות ,0,0,0,0,0,0
1814001140,החזר הוצאות ,0,0,0,0,0,0
1814001181,הפרשות סוציאליות ,0,0,0,0,0,0
1814001182,מיסים ועלויות ,0,0,0,0,0,0
1814001320,פיצויים ,0,0,0,0,0,0
1815200110,השכר הקובע-עמל ,155,155,163,-8,5,5000
1815200120,תוספות שאינן נכללות בשכר ,2,2,5,-3,150,150000
1815200130,שעות נוספות-עמל ,0,0,0,0,0,0
1815200140,החזר הוצאות-עמל ,5,5,5,0,0,0
1815200181,הפרשות סוציאליות ,34,34,34,0,0,0
1815200182,מיסים ועלויות ,12,12,13,-1,8,8000
1815201110,השכר הקבוע-אלנור ,35,35,19,16,45,45000
1815201120,תוספות שאינן נכללות בשכר ,0,0,0,0,0,0
1815201130,שעות נוספות-אלנור ,0,0,0,0,0,0
1815201140,החזר הוצאות-אלנור ,1,1,0,1,100,100000
1815201181,הפרשות סוציאליות ,7,7,2,5,71,71000
1815201182,מיסים ועלויות ,3,3,1,2,66,66000
1816600110,השכר הקובע ,0,0,0,0,0,0
1816600120,תוספות שאינן נכללות בש ,0,0,0,0,0,0
1816600130,שעות נוספות ,0,0,0,0,0,0
1816600140,החזר הוצאות ,0,0,0,0,0,0
1816600181,הפרשות סוציאליות ,0,0,0,0,0,0
1816600182,מיסים ועלויות ,0,0,0,0,0,0
1817100110,השכר הקובע ,27,27,33,-6,22,22000
1817100120,תוספות שאינן נכללות בש ,0,0,0,0,0,0
1817100130,שעות נוספות ,0,0,0,0,0,0
1817100140,החזר הוצאות ,0,0,0,0,0,0
1817100181,הפרשות סוציאליות ,7,7,8,-1,14,14000
1817100182,מיסים ועלויות ,2,2,2,0,0,0
1817200110,השכר הקובע ,0,0,0,0,0,0
1817200120,תוספות שאינן נכללות בש ,0,0,0,0,0,0
1817200130,שעות נוספות ,0,0,0,0,0,0
1817200140,החזר הוצאות ,0,0,0,0,0,0
1817200181,הפרשות סוציאליות ,0,0,0,0,0,0
1817200182,מסיים ועלויות ,0,0,0,0,0,0
1817300110,השכר הקובע ,447,447,547,-100,22,22000
1817300120,תוספות שאינן נכללות בשכר ,5,5,7,-2,40,40000
1817300130,שעות נוספות ,0,0,0,0,0,0
1817300140,החזר הוצאות ,131,131,156,-25,19,19000
1817300181,הפרשות סוציאליות ,99,99,123,-24,24,24000
1817300182,מיסים ועלויות ,45,45,54,-9,20,20000
1817300320,פיצויים ,0,0,0,0,0,0
1817600110,השכר הקובע ,15,15,30,-15,100,100000
1817600120,תוספות שאינן נכללות בש ,0,0,0,0,0,0
1817600130,שעות נוספות ,0,0,0,0,0,0
1817600140,החזר הוצאות ,0,0,0,0,0,0
1817600181,הפרשות סוציאליות ,1,1,1,0,0,0
1817600182,מיסים ועלויות ,1,1,2,-1,100,100000
1817700110,השכר הקובע ,81,81,54,27,33,33000
1817700120,תוספות שאינן נכללות בש ,1,1,0,1,100,100000
1817700130,שעות נוספות ,0,0,0,0,0,0
1817700140,החזר הוצאות ,15,15,13,2,13,13000
1817700181,הפרשות סוציאליות ,19,19,11,8,42,42000
1817700182,מיסים ועלויות ,7,7,5,2,28,28000
1817700320,פיצויים ,0,0,0,0,0,0
1817800110,השכר הקובע ,29,29,33,-4,13,13000
1817800120,תוספות שאינן נכללות בשכר ,1,1,2,-1,100,100000
1817800130,שעות נוספות ,0,0,0,0,0,0
1817800140,החזר הוצאות ,0,0,0,0,0,0
1817800181,הפרשות סוציאליות ,2,2,4,-2,100,100000
1817800182,מיסים ועלויות ,2,2,3,-1,50,50000
1817800320,פיצויים ,0,0,0,0,0,0
1817900110,השכר הקובע ,0,0,0,0,0,0
1817900120,תוספות שאינן נכללות בש ,0,0,0,0,0,0
1817900181,הוצאות סוציאליות ,0,0,0,0,0,0
1817900182,מיסים ועלויות ,0,0,0,0,0,0
1817900320,פיצויים ,0,0,0,0,0,0
1817910110,השכר הקובע-תפנית ,0,0,0,0,0,0
1817910120,תוספות שאינן נכללות בפנית ,0,0,0,0,0,0
1817910130,שעות נוספות-תפנית ,0,0,0,0,0,0
1817910140,החזר הוצאות-תפנית ,0,0,0,0,0,0
1817910181,הפרשות סוציאליות ,0,0,0,0,0,0
1817910182,מיסים ועלויות-תפנית ,0,0,0,0,0,0
1817910320,פיצויים-תפנית ,0,0,0,0,0,0
1818000110,השכר הקובע ,0,0,0,0,0,0
1818000120,תוספות שאינן נכללות בשכר ,0,0,0,0,0,0
1818000130,שעות נוספות ,0,0,0,0,0,0
1818000140,החזר הוצאות ,0,0,0,0,0,0
1818000181,הפרשות סוציאליןת ,0,0,0,0,0,0
1818000182,מיסים ועלויות ,0,0,0,0,0,0
1811000510,כיבוד ללא עודפות-חינוך ,0,0,0,0,0,0
1811000511,אירוח וכיבוד ,1,1,0,1,100,100000
1811000514,רכישת מתנות ,0,0,0,0,0,0
1811000521,השתלמויות ,7,7,21,-14,200,200000
1811000523,דמי חבר באירגונים ,1,1,1,0,0,0
1811000540,הוצאות תקשורת ,2,2,1,1,50,50000
1811000550,הוצאות פרסום ,0,0,0,0,0,0
1811000560,הוצאות משרדיות ,14,14,0,14,100,100000
1811000580,הוצאות ארגוניות שונות ,10,10,27,-17,170,170000
1811000730,רכב אסקודה ,0,0,0,0,0,0
1811000731,דלק ושמנים-חינוך ,30,30,34,-4,13,13000
1811000743,רכישת כלים ומכשור ,0,0,0,0,0,0
1811000750,עבודות קבלניות ,57,57,79,-22,38,38000
1811000751,שיפוצי בתי ספר ,0,0,0,0,0,0
1811000780,הוצאות שונות ,0,0,0,0,0,0
1811000930,רכישת ציוד יסודי ,4,4,3,1,25,25000
1811000931,רכישות כיתות לחינוך ,0,0,0,0,0,0
1812020522,ספרות מקצועית ועתונות ,0,0,0,0,0,0
1812200410,דמי חכירה ,250,250,251,-1,0,0
1812200431,חשמל ,82,82,74,8,9,9000
1812200432,מים ,128,128,86,42,32,32000
1812200433,חומרי נקיון ,2,2,0,2,100,100000
1812200450,רהוט ואחזקתו ,0,0,0,0,0,0
1812200540,הוצאות תקשורת ,7,7,8,-1,14,14000
1812200560,הוצאות משרדיות ,0,0,0,0,0,0
1812200580,הוצאות ארגוניות/אחרות ,1,1,2,-1,100,100000
1812200720,חומרים ,27,27,24,3,11,11000
1812200721,תש' הורים חומרים-חובה ,0,0,0,0,0,0
1812200743,רכישת כלים ומכשור ,0,0,41,-41,0,0
1812200750,עבודות קבלניות ,26,26,40,-14,53,53000
1812200753,הזנה ,180,180,161,19,10,10000
1812200930,רכישת ציוד יסודי ,10,10,68,-58,580,580000
1812300410,"שכ""ד ",200,200,163,37,18,18000
1812300420,"ששכ""ד ודמי חכירה ",0,0,0,0,0,0
1812300431,חשמל ,0,0,3,-3,0,0
1812300432,מים ,50,50,73,-23,46,46000
1812300433,חומרי נקיון ,37,37,34,3,8,8000
1812300540,הוצאות תקשורת ,6,6,7,-1,16,16000
1812300560,הוצאות משרדיות ,10,10,14,-4,40,40000
1812300580,הוצאות ארגוניות שונות ,4,4,4,0,0,0
1812300720,חומרים ,30,30,30,0,0,0
1812300721,"תש' הורים חומרים-ט""ח ",0,0,0,0,0,0
1812300743,רכישת כלים וציוד ,17,17,62,-45,264,264000
1812300750,עבודות קבלניות ,86,86,78,8,9,9000
1812300760,גננות עובדות מדינה ,3400,3400,3252,148,4,4000
1812300780,הוצאות שונות ,0,0,0,0,0,0
1812300930,רכישת ציוד יסודי ,104,104,145,-41,39,39000
1812302750,"עבודות קבלניות-גנ""י ט.חובה ",0,0,2,-2,0,0
1813200422,תחזוקת מבנים-חומרים ,0,0,0,0,0,0
1813200431,חשמל ,33,33,26,7,21,21000
1813200432,מים ,67,67,13,54,80,80000
1813200433,חומרי נקיון ,0,0,3,-3,0,0
1813200434,שרותי נקיון ,85,85,84,1,1,1000
1813200441,ביטוח ,0,0,0,0,0,0
1813200450,ע ,0,0,0,0,0,0
1813200511,אירוח וכיבוד ,0,0,0,0,0,0
1813200521,השתלמויות ,0,0,0,0,0,0
1813200522,ספרות מקצועית ,0,0,0,0,0,0
1813200540,הוצאות תקשורת ,8,8,9,-1,12,12000
1813200560,הוצאות משרדיות ,1,1,0,1,100,100000
1813200580,הוצאות ארגוניות/אחרות ,16,16,16,0,0,0
1813200720,חומרים ,5,5,0,5,100,100000
1813200721,תש' הורים חומרים-יסודי א' ,40,40,40,0,0,0
1813200722,אגרת שיכפול-יסודי א' ,12,12,14,-2,16,16000
1813200743,רכישת כלים ומכשור ,1,1,3,-2,200,200000
1813200750,עבודות קבלניות-יסודי א' ,10,10,4,6,60,60000
1813200751,"שמירה בי""ס חורה א' ",90,90,96,-6,6,6000
1813200752,דוברת קזוז שעות חורה א' ,0,0,0,0,0,0
1813200753,הזנת תלמידים יסודי א' ,90,90,89,1,1,1000
1813200780,הוצאות שונות-יסודי א' ,0,0,0,0,0,0
1813200781,"שח""פ-יסודי א' ",0,0,0,0,0,0
1813200930,רכישת ציוד יסודי ,6,6,13,-7,116,116000
1813201422,תחזוקת מבנים-חומרים ,0,0,0,0,0,0
1813201431,חשמל ,45,45,31,14,31,31000
1813201432,מים ,10,10,24,-14,140,140000
1813201433,חומרי נקיון ,4,4,0,4,100,100000
1813201434,שרותי נקיון ,47,47,63,-16,34,34000
1813201441,ביטוח ,0,0,0,0,0,0
1813201450,רהוט ואחזקתו ,0,0,0,0,0,0
1813201521,השתלמויות ,0,0,0,0,0,0
1813201522,ספרות מקצועית ,0,0,0,0,0,0
1813201540,הוצאות תקשורת ,5,5,5,0,0,0
1813201560,הוצאות משרדיות ,3,3,0,3,100,100000
1813201580,הוצאות ארגוניות/אחרות ,6,6,2,4,66,66000
1813201720,חומרים ,10,10,0,10,100,100000
1813201721,תש' הורים חומרים_אלעטו ,50,50,24,26,52,52000
1813201722,אגרת שיכפול ,12,12,25,-13,108,108000
1813201743,רכישת כלים ומכשור ,0,0,2,-2,0,0
1813201750,עבודות קבלניות-אלעטאונה ,24,24,23,1,4,4000
1813201751,"שמירה בי""ס אלעטאונה ",80,80,96,-16,20,20000
1813201752,דוברת קזוז שעות עטאונה ,0,0,0,0,0,0
1813201753,הזנת תלמידים אלעטאונה ,120,120,149,-29,24,24000
1813201760,"בי""ס אלעטאונה ",0,0,0,0,0,0
1813201780,הוצאות שונות-אלעטאונה ,0,0,0,0,0,0
1813201781,"שח""פ-אלעטאונה ",0,0,0,0,0,0
1813201810,השתת' בתקציב עטאונה אגרת ,0,0,0,0,0,0
1813201930,רכישת ציוד יסודי ,20,20,26,-6,30,30000
1813202431,חשמל ,65,65,51,14,21,21000
1813202432,מים ,30,30,53,-23,76,76000
1813202433,חומרי נקיון ,3,3,6,-3,100,100000
1813202434,שרותי נקיון ,115,115,97,18,15,15000
1813202522,ספרות מקצועית ועתונות ,0,0,0,0,0,0
1813202540,הוצאות תקשורת ,3,3,4,-1,33,33000
1813202560,הוצאות משרדיות ,0,0,0,0,0,0
1813202580,הוצאות ארגוניות/אחרות ,2,2,3,-1,50,50000
1813202720,חומרים ,6,6,0,6,100,100000
1813202721,תש' הורים חומרים-אלמג'ד ,35,35,33,2,5,5000
1813202722,אגרת שיכפול ,15,15,20,-5,33,33000
1813202743,רכישת כלים ומכשור ,0,0,2,-2,0,0
1813202750,עבודות קבלניות-אלמג'יד ,10,10,20,-10,100,100000
1813202751,"שמירה בי""ס אלמג'ד ",90,90,96,-6,6,6000
1813202752,דוברת קזוז שעות אלמג'ד ,0,0,0,0,0,0
1813202753,הזנת תלמידים אלמג'ד ,115,115,127,-12,10,10000
1813202780,הוצאות שונות-אלמג'יד ,0,0,0,0,0,0
1813202781,"שח""פ-אלמג'יד ",0,0,0,0,0,0
1813202930,רכישת ציוד יסודי ,0,0,0,0,0,0
1813203431,חשמל ,70,70,51,19,27,27000
1813203432,מים ,15,15,10,5,33,33000
1813203433,חומרי נקיון-אלביאדר ,5,5,13,-8,160,160000
1813203434,שרותי נקיון ,85,85,99,-14,16,16000
1813203522,ספרות מקצועית ועתונות ,0,0,0,0,0,0
1813203540,הוצאות תקשורת ,7,7,8,-1,14,14000
1813203560,הוצאות משרדיות ,1,1,0,1,100,100000
1813203570,מיכון ועיבוד נתונים ,0,0,0,0,0,0
1813203580,הוצאות ארגוניות שונות ,3,3,6,-3,100,100000
1813203720,חומרים ,20,20,6,14,70,70000
1813203721,תש' הורים חומרים-אלביאדר ,37,37,24,13,35,35000
1813203722,אגרת שכפול ,6,6,8,-2,33,33000
1813203743,"רכישת כלים,מכשירים וציוד ",1,1,2,-1,100,100000
1813203750,עבודות קבניות-אלביאדר ,60,60,17,43,71,71000
1813203751,"שמירה בי""ס אלביאדר ",90,90,96,-6,6,6000
1813203752,דוברת קזוז שעות ביאדר ,0,0,0,0,0,0
1813203753,הזנת תלמידים אלביאדר ,155,155,177,-22,14,14000
1813203780,הוצאות שונות ,35,35,0,35,100,100000
1813203781,"שח""פ-אלביאדר ",0,0,0,0,0,0
1813203930,רכישת ציוד יסודי ,6,6,6,1,16,16000
1813204431,חשמל-אנדלוס ,45,45,41,4,8,8000
1813204432,מים-אנדלוס ,10,10,16,-6,60,60000
1813204433,חומרי ניקוי-אנדלוס ,6,6,12,-6,100,100000
1813204434,שרותי ניקיון-אלאנדלוס ,67,67,62,5,7,7000
1813204522,ספרות מקצועית ועתונות ,0,0,0,0,0,0
1813204540,תקשורת-אנדלוס ,6,6,4,2,33,33000
1813204580,הוצאות ארגוניות שונות ,7,7,6,1,14,14000
1813204720,חומרים-אלאנדלוס ,8,8,0,8,100,100000
1813204721,תש' הורים חומרים-אלאנדלוס ,47,47,46,1,2,2000
1813204722,אגרת שיכפול-אלאנדלוס ,16,16,18,-2,12,12000
1813204743,כלים מכשירים וציוד ,0,0,2,-2,0,0
1813204750,עבודות קבלניות-אלאנדלוס ,55,55,55,0,0,0
1813204751,שמירה-אלאנדלוס ,95,95,96,-1,1,1000
1813204753,הזנת תלמידים אלאנדלס ,90,90,126,-36,40,40000
1813204780,הוצאות שונות-אנדלוס ,0,0,0,0,0,0
1813204930,ציוד יסודי-אלאנדלוס ,6,6,6,0,0,0
1813205431,חשמל - אלזהרא ,20,20,27,-7,35,35000
1813205432,מים - אלזהרא ,5,5,12,-7,140,140000
1813205433,חומרי ניקיון-אנדלוס ,2,2,7,-5,250,250000
1813205434,שרותי נקיון אלזהרא ,75,75,87,-12,16,16000
1813205540,תקשורת - אלזהרא ,2,2,3,-1,50,50000
1813205580,הוצאות אירגוניות ,24,24,26,-2,8,8000
1813205721,תש' הורים חומרים-אלזהרא ,32,32,32,0,0,0
1813205722,אגרת שיכפול ,12,12,16,-4,33,33000
1813205750,עבודות קבלניות אלזהרא ,80,80,65,15,18,18000
1813205751,שמירה-אלזהרא ,90,90,88,2,2,2000
1813205753,הזנת תלמידים אלזהרא ,90,90,90,0,0,0
1813205930,ציוד יסודי-אלזהרא ,15,15,16,-1,6,6000
1813300410,"שכ""ד ",300,300,213,87,29,29000
1813300431,חשמל-ח.מיוחד ,45,45,33,12,26,26000
1813300432,מים-ח.מיוחד ,5,5,17,-12,240,240000
1813300433,חומרי ניקיון-ח.מיוחד ,14,14,20,-6,42,42000
1813300434,נקיון-ח.מיוחד ,12,12,0,12,100,100000
1813300522,ספרות מקצועית ועתונות ,0,0,0,0,0,0
1813300540,תקשורת-ח.מיוחד ,1,1,1,0,0,0
1813300560,הוצאות משרדיות ,0,0,0,0,0,0
1813300580,הוצאות ארגוניות שונות ,7,7,12,-5,71,71000
1813300720,חומרים-ח.מיוחד ,11,11,11,0,0,0
1813300721,תש' הורים חומרים-ח.מיוחד ,52,52,77,-25,48,48000
1813300722,אגרת שכפול ,5,5,6,-1,20,20000
1813300743,"רכישת כלים,מכשירים וציוד ",0,0,19,-19,0,0
1813300750,עבודות קבלניות ,21,21,77,-56,266,266000
1813300751,שמירה - ח.מיוחד ,0,0,24,-24,0,0
1813300753,הזנה ,20,20,412,-392,960,960000
1813300780,הוצ' שונות ,0,0,0,0,0,0
1813300930,רכישת ציוד יסודי ,85,85,92,-7,8,8000
1813302410,"שכ""ד - אלופאא ",0,0,60,-60,0,0
1813302431,חשמל - אלופאא ,0,0,11,-11,0,0
1813302432,מים - אלופאא ,0,0,0,0,0,0
1813302433,חומרי ניקיון - אלופאא ,0,0,7,-7,0,0
1813302434,נקיון - אלופאא ,0,0,0,0,0,0
1813302470,ציוד משרדי - אוטיסטים ,0,0,7,-7,0,0
1813302540,תקשורת - אלופאא ,0,0,0,0,0,0
1813302721,תשלום הורים חומרים -אלופפא ,10,10,17,-7,70,70000
1813302722,אגרת שכפול אלופאא ,1,1,1,0,0,0
1813302743,רכישת כלים חומרים וציוד ,0,0,22,-22,0,0
1813302750,עבודות קבלניות - אלופאא ,0,0,77,-77,0,0
1813302753,הזנה - אלופאא ,0,0,72,-72,0,0
1813302930,ציוד יסודי - אוטיסטים ,0,0,95,-95,0,0
1813400410,"שכ""ד-מחוננים ",48,48,40,8,16,16000
1813400431,חשמל-מחוננים ,5,5,0,5,100,100000
1813400432,מים-מחוננים ,2,2,0,2,100,100000
1813400434,שרותי ניקיון-מחוננים ,15,15,4,11,73,73000
1813400540,הוצאות תקשורת-מחוננים ,5,5,3,2,40,40000
1813400580,הוצאות ארגוניות-מחוננים ,5,5,3,2,40,40000
1813400720,חומרים-מחוננים ,0,0,1,-1,0,0
1813400722,אגרת שכפול - מחוננים ,2,2,2,0,0,0
1813400760,חוגים לתלמידים מחוננים ,0,0,0,0,0,0
1813400930,ציוד יסודי-מחוננים ,40,40,41,-1,2,2000
1813600410,"שכ""ד - מתי""א ",24,24,24,0,0,0
1813600434,"נקיון מתי""א ",14,14,8,6,42,42000
1813600470,"ציוד משרדי - מתי""א ",34,34,34,0,0,0
1813600540,הוצאות תקשורת ,4,4,5,-1,25,25000
1813600580,"הוצאות אירגוניות מתי""א ",5,5,9,-4,80,80000
1813600721,תשלום הורים חומרים ,1,1,0,1,100,100000
1813600722,השתתפות מועצה ,15,15,22,-7,46,46000
1813600750,"עבודות קבלניות-מתי""א ",1,1,0,1,100,100000
1813600810,"השתת' ותרומות למוסדות עפ""י ח",0,0,0,0,0,0
1813600930,"ציוד יסודי-מתי""א ",55,55,57,-2,3,3000
1814000422,תחזוקת מבנים-חומרים ,0,0,0,0,0,0
1814000431,חשמל ,0,0,0,0,0,0
1814000432,מים ,30,30,0,30,100,100000
1814000433,חומרי נקיון ,0,0,0,0,0,0
1814000434,שרותי נקיון ,0,0,0,0,0,0
1814000450,רהוט ואחזקתו ,0,0,0,0,0,0
1814000470,ציוד משרדי מתכלה ,0,0,0,0,0,0
1814000511,אירוח וכיבוד ,0,0,0,0,0,0
1814000521,השתלמויות ,0,0,0,0,0,0
1814000522,ספרות מקצועית ,0,0,0,0,0,0
1814000710,הובלות והסעות קבלניות ,0,0,0,0,0,0
1814000720,חומרים ,0,0,0,0,0,0
1814000743,רכישת כלים ומכשור ,0,0,0,0,0,0
1814000750,עבודות קבלניות ,0,0,0,0,0,0
1814000760,"רשת עמל - חט""ב אלנור ",615,615,615,0,0,0
1814000930,רכישת ציוד יסודי ,0,0,7,-7,0,0
1815000431,חשמל ,0,0,0,0,0,0
1815200431,חשמל ,0,0,0,0,0,0
1815200450,רהוט ואחזקתו ,0,0,0,0,0,0
1815200521,השתלמויות ,0,0,0,0,0,0
1815200522,ספרות מקצועית ,0,0,0,0,0,0
1815200523,דמי חבר באירגונים ,0,0,0,0,0,0
1815200540,הוצאות תקשורת ,0,0,0,0,0,0
1815200560,הוצאות משרדיות ,0,0,0,0,0,0
1815200580,הוצאות ארגוניות/אחרות ,0,0,0,0,0,0
1815200750,עבודות קבלניות ,0,0,0,0,0,0
1815200760,"שכר מועבר - רשת עמל -בי""ס רב",2075,2075,2075,0,0,0
1815200930,רכישת ציוד יסודי ,0,0,0,0,0,0
1815201431,חשמל ,0,0,0,0,0,0
1815201433,חומרי נקיון ,0,0,0,0,0,0
1815201434,שרותי נקיון ,0,0,0,0,0,0
1815201450,רהוט ואחזקתו ,0,0,0,0,0,0
1815201511,אירוח וכיבוד ,0,0,0,0,0,0
1815201540,הוצאות תקשורת ,2,2,2,0,0,0
1815201560,ציוד משרדי ,0,0,0,0,0,0
1815201720,חומרים ,0,0,0,0,0,0
1815201721,תשלום הורים חומרים ,0,0,0,0,0,0
1815201722,דמי שיכפול ,0,0,0,0,0,0
1815201743,רכישת כלים ומכשרים ,0,0,0,0,0,0
1815201750,עבודות קבלניות ,57,57,62,-5,8,8000
1815201751,"שמירה בי""ס אלנור ",0,0,0,0,0,0
1815201760,"שכר מועבר - בי""ס עתיד ",3925,3925,3925,0,0,0
1815201930,רכישת ציוד יסודי ,0,0,0,0,0,0
1815202580,הוצ' ארגוניות/אחרות-סכנין ,5,5,5,0,0,0
1815202750,עבודות קבלניות סכנין ,33,33,33,0,0,0
1815202760,"שכר מועבר - בי""ס סכנין ",1800,1800,1800,0,0,0
1815203750,עבודות קבלניות-עהד ,1,1,25,-24,400,400000
1815203930,ציוד יסודי - עהד ,0,0,0,0,0,0
1815204750,עב' קבלניות - אלסלאם עמל ,0,0,0,0,0,0
1815204760,אלסלאם-שכר מועבר ,2000,2000,2507,-507,25,25000
1815900810,השתתפות למוסדות ,0,0,0,0,0,0
1816800850,מילגות לתלמידים ,180,180,95,85,47,47000
1817100750,עבודות קבלניות ,0,0,0,0,0,0
1817202580,הוצאות אירגוניות-סכנין ,0,0,0,0,0,0
1817300470,ציוד משרדי מתכלה ,0,0,0,0,0,0
1817300521,השתלמויות ,7,7,5,2,28,28000
1817300522,ספרות מקצועית ועתונות ,0,0,0,0,0,0
1817300523,דמי חבר באירגונים-פסיכולוגים,1,1,0,1,100,100000
1817300540,הוצאות תקשורת-פסיכולוגים ,6,6,8,-2,33,33000
1817300580,הוצאות ארגוניות שונות ,1,1,0,1,100,100000
1817300750,עבודות קבלניות ,0,0,0,0,0,0
1817300930,רכישת ציוד יסודי ,7,7,7,0,0,0
1817400750,עבודות קבלניות ,100,100,131,-31,31,31000
1817400780,הוצאות שונות ,0,0,0,0,0,0
1817500441,ביטוח ,145,145,147,-2,1,1000
1817600780,רווחה חינוכית ,100,100,9,91,91,91000
1817600781,"שח""ר-רווחה חינוכית ",140,140,0,140,100,100000
1817600840,השתתפויות-תמיכות רווחה ,0,0,0,0,0,0
1817600850,"השתתפות פרויקט פר""ח ",0,0,0,0,0,0
1817601780,הוצאות שונות ,0,0,0,0,0,0
1817601781,"שח""ר-רווחה חינוכית ",0,0,0,0,0,0
1817602780,הוצאות שונות ,0,0,0,0,0,0
1817602781,"רווחה חינוכית-חט""ב+מקיף ",0,0,0,0,0,0
1817603780,הוצאות שונות ,0,0,0,0,0,0
1817603781,רווחה חינוכית-גני ילדים ,0,0,0,0,0,0
1817700450,רהוט ואחזקתו ,0,0,0,0,0,0
1817700521,השתלמויות ,0,0,0,0,0,0
1817800750,עבודות קבלניות ,2100,2100,2205,-105,5,5000
1817801750,"הסעות-גנ""י ט.חובה ",120,120,0,120,100,100000
1817802750,הסעות-חינוך מיוחד)מוכר( ,900,900,887,13,1,1000
1817803750,הסעות ח.מיוחד מלוות ,0,0,26,-26,0,0
1817804750,"הסעות בי""ס סכנין ",15,15,36,-21,140,140000
1817805750,הסעות ח.מיוחד-לא מוכר ,80,80,111,-31,38,38000
1817809750,שכר מלוות ,350,350,141,209,59,59000
1817900441,ביטוח מוסדות חינוך ,138,138,142,-4,2,2000
1817900540,"תקשורת ואיטרנט לבי""ס ",0,0,0,0,0,0
1817900750,עבודות קבלניות ,0,0,0,0,0,0
1817900760,אגרות תלמידי חוץ ,205,205,197,8,3,3000
1817900770,"קניית שרות שכ""ל מרשות ",0,0,0,0,0,0
1817900780,הוצאות שונות ,20,20,0,20,100,100000
1817900781,"שרותי הזנת יוח""א ",0,0,0,0,0,0
1817900810,הש במוסדות)מ.חנוך סמים( ,0,0,0,0,0,0
1817900930,רכישת ציוד יסודי ,0,0,0,0,0,0
1817901750,עבודות קבלניות ,0,0,0,0,0,0
1817905750,עבודות קבלניות-מיוחדות ,0,0,0,0,0,0
1817910980,תפנית ,220,220,0,220,100,100000
1817920980,מצוינות ,0,0,0,0,0,0
1817930980,"אס""א-אלימות,סמים ואלכוהול ",0,0,0,0,0,0
1817940980,נוער במרכז העניינים ,25,25,2,23,92,92000
1817950980,פרויקטים שונים ,0,0,0,0,0,0
1818000810,השתת' ותרומות למוסדות ,0,0,0,0,0,0
1818200820,תמיכות ליחידים ,0,0,0,0,0,0
1841000110,השכר הקובע ,322,322,403,-81,25,25000
1841000120,תוספות שאינן נכללות בשכר ,7,7,7,0,0,0
1841000130,שעות נוספות ,36,36,38,-2,5,5000
1841000140,החזר הוצאות ,104,104,127,-23,22,22000
1841000181,הפרשות סוציאליות ,97,97,118,-21,21,21000
1841000182,מיסים ועלויות ,36,36,43,-7,19,19000
1841000320,פיצויים ,0,0,0,0,0,0
1845500110,השכר הקובע ,23,23,35,-12,52,52000
1845500120,תוספות שאינן נכללות בשכר ,0,0,0,0,0,0
1845500130,שעות נוספות ,0,0,0,0,0,0
1845500140,החזר הוצאות ,12,12,9,3,25,25000
1845500181,הפרשות סוציאליות ,4,4,9,-5,125,125000
1845500182,מיסים ועלויות ,3,3,3,0,0,0
1841000410,שכר דירה ודמי חכירה ,0,0,0,0,0,0
1841000431,חשמל ,0,0,0,0,0,0
1841000514,רכישת מתנות ,0,0,0,0,0,0
1841000521,השתלמויות ,2,2,0,2,100,100000
1841000523,דמי חבר באירגונים ,0,0,0,0,0,0
1841000540,הוצאות תקשורת ,0,0,0,0,0,0
1841000560,הוצאות משרדיות ,0,0,0,0,0,0
1841000580,הוצאות ארגוניות/אחרות ,3,3,4,-1,33,33000
1841000750,עבודות קבלניות ,0,0,10,-10,0,0
1841000930,רכישת ציוד יסודי ,0,0,24,-24,0,0
1842200840,משפחות במצוקה בקהילה ,48,48,37,11,22,22000
1842202840,טיפול בפרט במשפחה ,0,0,0,0,0,0
1842203840,טיפול באלכהולסטים ,9,9,10,-1,11,11000
1842204840,סיוע למשפחות עם ילדי א ,52,52,87,-35,67,67000
1842205840,טיפול בהורים ובילדיהם ,0,0,0,0,0,0
1842402840,טיפול בפרט ובמשפחה ,0,0,0,0,0,0
1842600840,מרכזי טיפול באלימות ,0,0,55,-55,0,0
1843501750,טיפול בילד בקהילה ,0,0,24,-24,0,0
1843501840,טיפול בילד בקהילה ,0,0,212,-212,0,0
1843502840,טיפול בילד בקהילה-פר ,0,0,0,0,0,0
1843503840,ת.לאומית ילד ונוער ,0,0,31,-31,0,0
1843504840,יצירת קשר הורים ילדי ב- ,0,0,3,-3,0,0
1843505840,טיפול במשפחות-אומנה יומית ,49,49,0,49,100,100000
1843506840,מועדניות ביתיות ,210,210,6,204,97,97000
1843507840,יצירת קשר הורים ,0,0,0,0,0,0
1843800840,אחזקת ילדים בפנמיות ,495,495,482,13,2,2000
1843801840,טיפול במשפחות אומנה ,0,0,177,-177,0,0
1843900840,ילדים במעון יום ,516,516,1043,-527,102,102000
1843901840,"משפחתונים - תמ""ת ",120,120,106,14,11,11000
1844030750,נופשונים להבראה ,0,0,0,0,0,0
1844400840,טיפול בזקן בקהילה ,12,12,11,1,8,8000
1844401840,חימום לקשישים ,0,0,0,0,0,0
1844402410,שכר דירה ,0,0,0,0,0,0
1844402580,טיפול בקשיש-הוצ' אחרות ,0,0,0,0,0,0
1844402840,מועדונים לזקנים ,0,0,0,0,0,0
1844403840,נופשונים להבראה )לקשיש( ,0,0,21,-21,0,0
1844409580,הוצ' אחרות טיפול בקשיש ,0,0,4,-4,0,0
1845100750,עבודות קבלניות ,0,0,0,0,0,0
1845100840,סדור מפגרים במוסדות ,1073,1073,1294,-221,20,20000
1845101840,מפגרים במוסד ממשלתי ,0,0,0,0,0,0
1845200840,מפגרים במעון טיפולי ,53,53,72,-19,35,35000
1845300840,שרותים תומכים למפגר ,11,11,3,8,72,72000
1845301840,נופשונים למפגר ,2,2,0,2,100,100000
1845302840,הסעות למ.יום למפגר ,19,19,18,1,5,5000
1845305840,הסעות לאוטיסטים ,1,1,0,1,100,100000
1845400840,"מעשי""ם מפעלי תעסוקה למפגר ",44,44,80,-36,81,81000
1846300840,עמי ליווי לעיור ,0,0,0,0,0,0
1846301840,הדרכת העוור ובני ביתו ,7,7,2,5,71,71000
1846302840,מכונים לראיה ירודה ,0,0,0,0,0,0
1846303840,מועדונים לעיוור ,0,0,1,-1,0,0
1846304840,אחזקת נכים במשפחות אומנה ,0,0,2,-2,0,0
1846305840,משפחות אומנה לשיקום ,0,0,0,0,0,0
1846400840,תעסוקה מוגנת למוגבל ,0,0,0,0,0,0
1846400841,תעסוקה מוגנת למוגבל-עוור ,0,0,0,0,0,0
1846500840,אחזקת נכים בפנימיות ,153,153,168,-15,9,9000
1846600840,מס. יום לילד המוגבל ,61,61,34,27,44,44000
1846601840,מרכזי איבחון ושיקום ,0,0,0,0,0,0
1846700840,מפעלי תעסוקה-ומעדון שי ,0,0,0,0,0,0
1846701750,עבודות קבלניות ,0,0,0,0,0,0
1846701840,שיקום נכים בקהילה ,0,0,0,0,0,0
1846702750,עב' קבלניות-מ.יום לנכים ,35,35,175,-140,400,400000
1846702840,מ.יום שיקום לנכים ,231,231,260,-29,12,12000
1846801840,דמי תקשורת ,0,0,0,0,0,0
1847100580,הוצאות ארגוניות/אחרות ,0,0,15,-15,0,0
1847100750,נוער במצוקה ,0,0,1,-1,0,0
1847100840,טפול בנוער וצעירים ,16,16,0,16,100,100000
1847102840,מקלט לנשים מוכות ,40,40,111,-71,177,177000
1847400840,שהות במקלט לנערות ,0,0,16,-16,0,0
1848200750,פיתוח קהילתי במגזר הכפרי ,0,0,0,0,0,0
1848200840,מרכזים קהילתיים ,0,0,0,0,0,0
1848201840,תוכנית עם הפנים לקהילה ,0,0,209,-209,0,0
1848202750,פיתוח ק.במגזר הכפרי ,0,0,0,0,0,0
1848202840,פיתוח ק. במגזר הכפרי ,0,0,0,0,0,0
1848500840,עובדי שיקום שכונות ,0,0,0,0,0,0
1972000691,"ע""ח קרן ",691,691,691,0,0,0
1972000692,"ע""ח ריבית ",511,511,617,-106,20,20000
1972000693,"ע""ח הצמדה ",168,168,175,-7,4,4000
1972000694,"תש' ע""ח קרן ביוב ",0,0,0,0,0,0
1972000695,"תש' ע""ח רבית ביוב ",0,0,0,0,0,0
1972000696,"תש' ע""ח הצמדה ביוב ",0,0,0,0,0,0
1648100691,"ע""ח קרן ",0,0,117,-117,0,0
1648100692,"ע""ח רבית ",0,0,0,0,0,0
1648100693,"ע""ח הצמדה ",0,0,0,0,0,0
1649100691,"ע""ח קרן ",0,0,0,0,0,0
1649100692,"ע""ח ריבית ",0,0,0,0,0,0
1649100693,"ע""ח הצמדה ",0,0,0,0,0,0
1631000610,עמלות והוצאות בנקאיות ,50,50,56,-6,12,12000
1632000620,ריבית משיכות יתר ,10,10,11,-1,10,10000
1632000640,ריבית ב.לאומי ומס הכנסה ,40,40,36,4,10,10000
1632000650,ריבית פ.ספקים ונותני שרות ,60,60,245,-185,308,308000
1633000670,"רבית על הלוואות ק""מ ",100,100,47,53,53,53000
1992000960,רזרבה להתייקריות ,0,0,0,0,0,0
1992100960,הוצאה מותנת בגביה ,1175,1175,0,1175,100,100000
1992200960,הוצאה מותנת בהכנסה ,0,0,172,-172,0,0
1993000980,מס הכנסה שנים קודמות ,0,0,0,0,0,0
1994000580,הוצאות אחרות ,0,0,0,0,0,0
1994000980,הוצאות אחרות ,0,0,0,0,0,0
1999100980,מענק לכסוי גרעון ,0,0,320,-320,0,0
1995000860,הנחות ממיסים ,4500,4500,6749,-2249,49,49000
